,combined_fips,county_name,state_name,Median Age,Population,Total_ForeignBorn,Total_2010,Natu_2010,NCit_2010,Total_2000,Natu_2000,NCit_2000,Total_1990,Natu_1990,NCit_1990,Total_Early90,Natu_Early90,NCit_Early90,Poverty Count,Household Income,Per Capita Income,combined_name,county_fips,state_fips,Poverty Rate
0,1001,Autauga County, Alabama,37.8,55049,1012,146,3,143,297,61,236,204,109,95,365,302,63,6697,53099,26168,"Autauga County, Alabama",1,1,12.16552526
1,1003,Baldwin County, Alabama,42.3,199510,6523,1196,39,1157,2097,664,1433,1325,491,834,1905,1476,429,25551,51365,28069,"Baldwin County, Alabama",3,1,12.80687685
2,1005,Barbour County, Alabama,38.7,26614,761,68,0,68,479,111,368,141,66,75,73,56,17,6235,33956,17249,"Barbour County, Alabama",5,1,23.42751935
3,1007,Bibb County, Alabama,40.2,22572,305,80,0,80,113,6,107,72,69,3,40,3,37,3390,39776,18988,"Bibb County, Alabama",7,1,15.01860712
4,1009,Blount County, Alabama,40.8,57704,2465,222,105,117,952,85,867,836,270,566,455,227,228,9441,46212,21033,"Blount County, Alabama",9,1,16.36108415
5,1011,Bullock County, Alabama,39.2,10552,160,30,0,30,53,0,53,11,11,0,66,66,0,2728,29335,17909,"Bullock County, Alabama",11,1,25.85291888
6,1013,Butler County, Alabama,40.6,20280,283,69,0,69,73,53,20,61,61,0,80,49,31,5126,34315,19011,"Butler County, Alabama",13,1,25.27613412
7,1015,Calhoun County, Alabama,39.1,115883,2774,436,41,395,774,209,565,517,158,359,1047,607,440,22135,41954,22231,"Calhoun County, Alabama",15,1,19.10116238
8,1017,Chambers County, Alabama,43.1,34018,337,145,0,145,116,5,111,29,29,0,47,18,29,6805,36027,21532,"Chambers County, Alabama",17,1,20.00411547
9,1019,Cherokee County, Alabama,45.7,25897,188,10,10,0,61,13,48,13,13,0,104,88,16,4188,38925,22544,"Cherokee County, Alabama",19,1,16.17175735
10,1021,Chilton County, Alabama,38.7,43817,2435,278,8,270,1217,103,1114,659,179,480,281,93,188,8779,42594,22045,"Chilton County, Alabama",21,1,20.03560262
11,1023,Choctaw County, Alabama,45.1,13287,22,2,0,2,5,0,5,4,4,0,11,7,4,2743,32622,20773,"Choctaw County, Alabama",23,1,20.64423873
12,1025,Clarke County, Alabama,42,24847,116,1,0,1,0,0,0,30,20,10,85,61,24,6023,32735,20543,"Clarke County, Alabama",25,1,24.24035095
13,1027,Clay County, Alabama,43.7,13483,255,0,0,0,194,3,191,8,0,8,53,36,17,2195,38815,21115,"Clay County, Alabama",27,1,16.2797597
14,1029,Cleburne County, Alabama,41.5,14991,262,0,0,0,130,0,130,80,13,67,52,52,0,2889,36316,19791,"Cleburne County, Alabama",29,1,19.27156294
15,1031,Coffee County, Alabama,39.3,50991,1906,181,4,177,543,61,482,385,298,87,797,602,195,8219,47872,25325,"Coffee County, Alabama",31,1,16.11853072
16,1033,Colbert County, Alabama,42.4,54377,849,145,16,129,128,62,66,276,116,160,300,232,68,8910,43786,23318,"Colbert County, Alabama",33,1,16.38560421
17,1035,Conecuh County, Alabama,44,12697,108,17,0,17,27,16,11,6,6,0,58,32,26,4107,27609,16004,"Conecuh County, Alabama",35,1,32.34622352
18,1037,Coosa County, Alabama,44.9,10864,136,47,0,47,55,0,55,33,19,14,1,1,0,1610,31910,18080,"Coosa County, Alabama",37,1,14.81958763
19,1039,Covington County, Alabama,42.9,37729,360,6,0,6,113,45,68,83,48,35,158,142,16,7031,37313,21738,"Covington County, Alabama",39,1,18.63553235
20,1041,Crenshaw County, Alabama,41.6,13896,318,20,0,20,222,45,177,23,10,13,53,53,0,2484,37557,20455,"Crenshaw County, Alabama",41,1,17.87564767
21,1043,Cullman County, Alabama,40.5,81316,2304,198,20,178,1065,330,735,673,251,422,368,175,193,13718,39297,21041,"Cullman County, Alabama",43,1,16.86998869
22,1045,Dale County, Alabama,36.9,49607,1362,238,0,238,384,215,169,176,108,68,564,479,85,9897,44093,22834,"Dale County, Alabama",45,1,19.95081339
23,1047,Dallas County, Alabama,38.9,41426,610,64,0,64,291,11,280,88,34,54,167,148,19,14027,28136,17611,"Dallas County, Alabama",47,1,33.86037754
24,1049,DeKalb County, Alabama,39.3,70937,5162,358,20,338,2460,386,2074,1648,235,1413,696,364,332,13872,38248,18685,"DeKalb County, Alabama",49,1,19.55538013
25,1051,Elmore County, Alabama,38.3,80957,1580,119,18,101,691,73,618,246,101,145,524,352,172,10893,53398,24771,"Elmore County, Alabama",51,1,13.45529108
26,1053,Escambia County, Alabama,39.9,37875,279,36,0,36,119,60,59,107,69,38,17,17,0,8894,32334,17420,"Escambia County, Alabama",53,1,23.48250825
27,1055,Etowah County, Alabama,40.9,103363,2979,254,6,248,879,192,687,955,275,680,891,571,320,18713,40478,21287,"Etowah County, Alabama",55,1,18.10415719
28,1057,Fayette County, Alabama,43.6,16783,94,26,26,0,26,26,0,0,0,0,42,19,23,2863,36205,20201,"Fayette County, Alabama",57,1,17.05892868
29,1059,Franklin County, Alabama,39.1,31573,2805,358,15,343,1276,180,1096,786,226,560,385,150,235,6951,36138,18193,"Franklin County, Alabama",59,1,22.01564628
30,1061,Geneva County, Alabama,42,26765,449,0,0,0,207,26,181,147,40,107,95,48,47,6011,36519,20189,"Geneva County, Alabama",61,1,22.45843452
31,1063,Greene County, Alabama,41.3,8587,22,2,0,2,0,0,0,0,0,0,20,20,0,3233,21339,13679,"Greene County, Alabama",63,1,37.64993595
32,1065,Hale County, Alabama,39.7,15159,157,0,0,0,62,49,13,9,0,9,86,80,6,3858,33351,19296,"Hale County, Alabama",65,1,25.45022759
33,1067,Henry County, Alabama,43.2,17187,294,41,0,41,108,5,103,81,11,70,64,41,23,2586,41045,22825,"Henry County, Alabama",67,1,15.04625589
34,1069,Houston County, Alabama,39.3,103891,2407,197,48,149,897,226,671,524,308,216,789,658,131,19415,41945,24086,"Houston County, Alabama",69,1,18.68785554
35,1071,Jackson County, Alabama,42.8,52608,1187,187,50,137,350,161,189,374,175,199,276,233,43,9780,38422,20487,"Jackson County, Alabama",71,1,18.59032847
36,1073,Jefferson County, Alabama,37.5,659096,25875,4427,116,4311,11877,2255,9622,4981,2342,2639,4590,3875,715,116750,47220,28162,"Jefferson County, Alabama",73,1,17.71365628
37,1075,Lamar County, Alabama,44.3,14066,119,9,0,9,77,9,68,20,20,0,13,13,0,3322,34298,20206,"Lamar County, Alabama",75,1,23.61723304
38,1077,Lauderdale County, Alabama,41.3,92641,1902,367,16,351,503,215,288,476,237,239,556,386,170,16538,43657,24893,"Lauderdale County, Alabama",77,1,17.85170713
39,1079,Lawrence County, Alabama,42.2,33433,243,0,0,0,110,7,103,83,73,10,50,35,15,6050,42339,21911,"Lawrence County, Alabama",79,1,18.09589328
40,1081,Lee County, Alabama,30.5,153947,7940,2509,48,2461,3088,385,2703,1065,609,456,1278,1034,244,34085,45056,24951,"Lee County, Alabama",81,1,22.14073675
41,1083,Limestone County, Alabama,39,90257,3908,326,88,238,1733,668,1065,782,235,547,1067,867,200,12290,51115,26086,"Limestone County, Alabama",83,1,13.61667239
42,1085,Lowndes County, Alabama,40.4,10565,32,0,0,0,8,0,8,6,0,6,18,18,0,3005,27914,18434,"Lowndes County, Alabama",85,1,28.44297208
43,1087,Macon County, Alabama,38.2,19684,222,55,0,55,102,39,63,2,0,2,63,63,0,4442,32390,18385,"Macon County, Alabama",87,1,22.56655151
44,1089,Madison County, Alabama,38.1,349973,19461,2691,225,2466,6533,1736,4797,4101,1966,2135,6136,4986,1150,45287,60150,33264,"Madison County, Alabama",89,1,12.9401411
45,1091,Marengo County, Alabama,42.2,20066,182,34,0,34,83,0,83,46,14,32,19,19,0,5504,30713,20359,"Marengo County, Alabama",91,1,27.42948271
46,1093,Marion County, Alabama,43.9,30239,489,56,2,54,238,209,29,55,50,5,140,98,42,5509,34074,20998,"Marion County, Alabama",93,1,18.21819505
47,1095,Marshall County, Alabama,38.8,94534,6779,569,38,531,2840,228,2612,2273,532,1741,1097,324,773,19138,39831,21767,"Marshall County, Alabama",95,1,20.24456809
48,1097,Mobile County, Alabama,37.2,414291,12864,2307,93,2214,4145,1272,2873,2426,1627,799,3986,3162,824,78633,44263,23318,"Mobile County, Alabama",97,1,18.98013715
49,1099,Monroe County, Alabama,41.5,21975,44,0,0,0,0,0,0,7,0,7,37,37,0,6972,28182,16556,"Monroe County, Alabama",99,1,31.72696246
50,1101,Montgomery County, Alabama,36,227392,9912,2383,68,2315,3331,511,2820,1659,748,911,2539,1889,650,46982,45358,26255,"Montgomery County, Alabama",101,1,20.66123698
51,1103,Morgan County, Alabama,39.8,119555,5163,668,73,595,1895,211,1684,1600,281,1319,1000,545,455,19172,46883,24415,"Morgan County, Alabama",103,1,16.036134
52,1105,Perry County, Alabama,37.1,9856,37,12,0,12,0,0,0,25,25,0,0,0,0,3605,24912,14033,"Perry County, Alabama",105,1,36.57670455
53,1107,Pickens County, Alabama,42.2,20042,312,86,0,86,62,0,62,80,10,70,84,18,66,4575,31679,19188,"Pickens County, Alabama",107,1,22.82706317
54,1109,Pike County, Alabama,31.2,33277,1293,488,0,488,485,45,440,149,54,95,171,97,74,8074,33193,20180,"Pike County, Alabama",109,1,24.26300448
55,1111,Randolph County, Alabama,42.8,22615,361,1,0,1,225,19,206,57,40,17,78,73,5,4542,37496,19584,"Randolph County, Alabama",111,1,20.08401503
56,1113,Russell County, Alabama,34.8,58636,1667,176,9,167,564,168,396,589,395,194,338,267,71,12423,38400,20760,"Russell County, Alabama",113,1,21.18664302
57,1115,St. Clair County, Alabama,40,86576,1520,194,48,146,691,99,592,210,180,30,425,325,100,11582,54042,24474,"St. Clair County, Alabama",115,1,13.37784143
58,1117,Shelby County, Alabama,38.1,205951,11246,1647,89,1558,4194,746,3448,2824,913,1911,2581,2045,536,17227,72310,34117,"Shelby County, Alabama",117,1,8.364611
59,1119,Sumter County, Alabama,36.5,13285,269,211,0,211,38,0,38,8,5,3,12,12,0,4582,20428,13929,"Sumter County, Alabama",119,1,34.49002635
60,1121,Talladega County, Alabama,40.8,81057,1249,329,28,301,215,56,159,434,115,319,271,140,131,16119,37923,20430,"Talladega County, Alabama",121,1,19.88600614
61,1123,Tallapoosa County, Alabama,43,40958,597,0,0,0,353,193,160,167,121,46,77,66,11,9431,39395,21410,"Tallapoosa County, Alabama",123,1,23.02602666
62,1125,Tuscaloosa County, Alabama,32.1,202471,7127,2155,96,2059,2696,626,2070,918,411,507,1358,1071,287,34470,48022,23896,"Tuscaloosa County, Alabama",125,1,17.02466032
63,1127,Walker County, Alabama,42.3,65593,937,116,0,116,396,29,367,266,15,251,159,112,47,14174,37025,20410,"Walker County, Alabama",127,1,21.60901316
64,1129,Washington County, Alabama,41.4,16909,174,6,0,6,118,30,88,35,35,0,15,15,0,3585,40293,19598,"Washington County, Alabama",129,1,21.20172689
65,1131,Wilcox County, Alabama,40.2,11119,0,0,0,0,0,0,0,0,0,0,0,0,0,3768,24442,14800,"Wilcox County, Alabama",131,1,33.88793956
66,1133,Winston County, Alabama,44.1,24013,314,10,0,10,142,12,130,89,27,62,73,72,1,4833,33896,19299,"Winston County, Alabama",133,1,20.12659809
67,2013,Aleutians East Borough, Alaska,42.8,3299,1342,341,37,304,448,120,328,269,109,160,284,150,134,510,65926,31025,"Aleutians East Borough, Alaska",13,2,15.45923007
68,2016,Aleutians West Census Area, Alaska,37.6,5714,2105,436,21,415,726,251,475,477,280,197,466,325,141,426,86964,35083,"Aleutians West Census Area, Alaska",16,2,7.455372769
69,2020,Anchorage Municipality, Alaska,32.8,299321,30806,4199,662,3537,8952,4214,4738,7061,4955,2106,10594,8566,2028,23652,80862,37864,"Anchorage Municipality, Alaska",20,2,7.901884599
70,2050,Bethel Census Area, Alaska,26.8,17885,322,47,2,45,103,37,66,61,32,29,111,81,30,4619,53296,18231,"Bethel Census Area, Alaska",50,2,25.82611127
71,2060,Bristol Bay Borough, Alaska,40.7,942,23,3,0,3,0,0,0,12,9,3,8,5,3,67,88000,41420,"Bristol Bay Borough, Alaska",60,2,7.112526539
72,2068,Denali Borough, Alaska,37.3,2125,132,102,0,102,3,0,3,21,16,5,6,5,1,233,81302,38337,"Denali Borough, Alaska",68,2,10.96470588
73,2070,Dillingham Census Area, Alaska,29.7,4980,122,3,0,3,32,6,26,34,29,5,53,43,10,815,56055,23520,"Dillingham Census Area, Alaska",70,2,16.36546185
74,2090,Fairbanks North Star Borough, Alaska,30.7,100150,5199,958,104,854,1258,576,682,1197,834,363,1786,1297,489,7444,73831,34182,"Fairbanks North Star Borough, Alaska",90,2,7.432850724
75,2100,Haines Borough, Alaska,44.6,2528,123,5,0,5,28,8,20,0,0,0,90,34,56,132,53125,32673,"Haines Borough, Alaska",100,2,5.221518987
76,2105,Hoonah-Angoon Census Area, Alaska,48.4,2107,127,46,0,46,62,36,26,2,2,0,17,16,1,260,54091,31451,"Hoonah-Angoon Census Area, Alaska",105,2,12.33981965
77,2110,Juneau City and Borough, Alaska,37.5,32524,2656,327,11,316,930,338,592,517,336,181,882,742,140,2365,87436,40592,"Juneau City and Borough, Alaska",110,2,7.271553314
78,2122,Kenai Peninsula Borough, Alaska,40.5,57637,1624,386,33,353,318,182,136,195,134,61,725,612,113,6175,64891,32556,"Kenai Peninsula Borough, Alaska",122,2,10.71360411
79,2130,Ketchikan Gateway Borough, Alaska,39.2,13715,1122,156,0,156,428,201,227,223,168,55,315,277,38,1453,64162,32694,"Ketchikan Gateway Borough, Alaska",130,2,10.59423988
80,2150,Kodiak Island Borough, Alaska,32.7,13918,2606,505,32,473,642,255,387,648,472,176,811,717,94,1247,73068,32066,"Kodiak Island Borough, Alaska",150,2,8.959620635
81,2158,Kusilvak Census Area, Alaska,23.3,7993,78,31,0,31,12,1,11,12,6,6,23,12,11,2862,38160,11701,"Kusilvak Census Area, Alaska",158,2,35.80633054
82,2164,Lake and Peninsula Borough, Alaska,31.9,1411,52,30,0,30,7,4,3,4,4,0,11,8,3,263,43864,22684,"Lake and Peninsula Borough, Alaska",164,2,18.63926293
83,2170,Matanuska-Susitna Borough, Alaska,34.8,98679,3236,420,56,364,835,389,446,823,543,280,1158,903,255,9350,73908,30078,"Matanuska-Susitna Borough, Alaska",170,2,9.475166955
84,2180,Nome Census Area, Alaska,27.7,9879,176,28,5,23,22,3,19,62,31,31,64,36,28,2593,51563,20033,"Nome Census Area, Alaska",180,2,26.24759591
85,2185,North Slope Borough, Alaska,33.8,9681,594,97,14,83,135,59,76,151,77,74,211,110,101,1070,72027,49982,"North Slope Borough, Alaska",185,2,11.05257721
86,2188,Northwest Arctic Borough, Alaska,26.3,7723,98,41,3,38,32,18,14,8,5,3,17,14,3,1874,61341,21028,"Northwest Arctic Borough, Alaska",188,2,24.26518192
87,2195,Petersburg Borough, Alaska,40.8,3196,250,31,0,31,39,19,20,73,34,39,107,88,19,294,63940,34788,"Petersburg Borough, Alaska",195,2,9.198998748
88,2198,Prince of Wales-Hyder Census Area, Alaska,40.5,6374,126,21,2,19,50,29,21,21,8,13,34,24,10,938,51887,25564,"Prince of Wales-Hyder Census Area, Alaska",198,2,14.71603389
89,2220,Sitka City and Borough, Alaska,39.1,8921,754,172,13,159,184,61,123,92,53,39,306,261,45,796,70160,35655,"Sitka City and Borough, Alaska",220,2,8.922766506
90,2230,Skagway Municipality, Alaska,44.1,1014,87,4,0,4,28,10,18,33,3,30,22,17,5,53,64853,39412,"Skagway Municipality, Alaska",230,2,5.226824458
91,2240,Southeast Fairbanks Census Area, Alaska,36.4,6970,751,91,4,87,287,203,84,174,41,133,199,123,76,941,63713,30757,"Southeast Fairbanks Census Area, Alaska",240,2,13.50071736
92,2261,Valdez-Cordova Census Area, Alaska,37.6,9522,502,85,0,85,78,49,29,125,106,19,214,194,20,802,82511,35457,"Valdez-Cordova Census Area, Alaska",261,2,8.422600294
93,2275,Wrangell City and Borough, Alaska,48.8,2401,110,34,0,34,19,5,14,41,36,5,16,16,0,237,52986,29782,"Wrangell City and Borough, Alaska",275,2,9.87088713
94,2282,Yakutat City and Borough, Alaska,40.5,646,41,13,0,13,15,15,0,6,6,0,7,6,1,51,66875,31084,"Yakutat City and Borough, Alaska",282,2,7.894736842
95,2290,Yukon-Koyukuk Census Area, Alaska,35.2,5600,83,9,0,9,16,7,9,19,7,12,39,25,14,1304,38451,20812,"Yukon-Koyukuk Census Area, Alaska",290,2,23.28571429
96,4001,Apache County, Arizona,33.5,72346,1244,245,8,237,296,43,253,262,68,194,441,236,205,25658,32460,13428,"Apache County, Arizona",1,4,35.46567882
97,4003,Cochise County, Arizona,40.3,128177,14687,1464,183,1281,3058,779,2279,2530,1074,1456,7635,5453,2182,22184,45383,23757,"Cochise County, Arizona",3,4,17.30731723
98,4005,Coconino County, Arizona,30.7,138064,6662,1213,54,1159,1979,504,1475,1507,672,835,1963,1540,423,28193,51106,24711,"Coconino County, Arizona",5,4,20.42023989
99,4007,Gila County, Arizona,48.9,53179,2260,163,14,149,527,124,403,575,145,430,995,815,180,11097,40593,21470,"Gila County, Arizona",7,4,20.86725963
100,4009,Graham County, Arizona,32.4,37529,1646,286,7,279,507,88,419,380,129,251,473,271,202,7419,47422,17710,"Graham County, Arizona",9,4,19.7687122
101,4011,Greenlee County, Arizona,33.3,9224,422,77,4,73,212,83,129,98,49,49,35,25,10,1216,51813,23778,"Greenlee County, Arizona",11,4,13.18300087
102,4012,La Paz County, Arizona,55.1,20304,2309,471,0,471,558,71,487,441,77,364,839,487,352,4243,36321,21447,"La Paz County, Arizona",12,4,20.89736013
103,4013,Maricopa County, Arizona,35.8,4088549,602216,70093,4861,65232,165621,39277,126344,171977,60062,111915,194525,127928,66597,666513,55676,28791,"Maricopa County, Arizona",13,4,16.30194477
104,4015,Mohave County, Arizona,49.7,203629,14191,857,65,792,2505,559,1946,3381,1188,2193,7448,4485,2963,37884,39856,22026,"Mohave County, Arizona",15,4,18.60442275
105,4017,Navajo County, Arizona,35.8,108209,3154,504,22,482,753,182,571,546,134,412,1351,966,385,31575,36868,16564,"Navajo County, Arizona",17,4,29.1796431
106,4019,Pima County, Arizona,38.1,1003338,129465,15771,1070,14701,33053,8183,24870,27539,12389,15150,53102,38108,14994,186299,46764,26204,"Pima County, Arizona",19,4,18.56792028
107,4021,Pinal County, Arizona,38.3,397604,39255,6739,208,6531,8585,1679,6906,8943,3363,5580,14988,9862,5126,61430,51190,21982,"Pinal County, Arizona",21,4,15.45004577
108,4023,Santa Cruz County, Arizona,36.4,46547,15195,1169,116,1053,2989,1113,1876,2857,1622,1235,8180,5827,2353,10083,38941,18860,"Santa Cruz County, Arizona",23,4,21.66197607
109,4025,Yavapai County, Arizona,51.9,218586,14114,997,38,959,3107,656,2451,3704,1043,2661,6306,4457,1849,31512,46638,26584,"Yavapai County, Arizona",25,4,14.41629382
110,4027,Yuma County, Arizona,34,203292,54728,6440,618,5822,12695,3299,9396,12492,5423,7069,23101,13539,9562,40330,41467,19483,"Yuma County, Arizona",27,4,19.83845897
111,5001,Arkansas County, Arkansas,41.2,18569,209,1,0,1,50,0,50,130,14,116,28,22,6,3587,37330,23287,"Arkansas County, Arkansas",1,5,19.31714147
112,5003,Ashley County, Arkansas,41.5,20989,545,2,0,2,155,44,111,245,19,226,143,119,24,4131,36352,20290,"Ashley County, Arkansas",3,5,19.68173805
113,5005,Baxter County, Arkansas,51.8,40992,965,144,36,108,47,7,40,123,75,48,651,589,62,5600,38115,23068,"Baxter County, Arkansas",5,5,13.66120219
114,5007,Benton County, Arkansas,35.1,245231,27574,4968,318,4650,7404,1487,5917,7914,2878,5036,7288,4292,2996,27562,59016,28996,"Benton County, Arkansas",7,5,11.23919896
115,5009,Boone County, Arkansas,42.4,37301,298,28,3,25,110,15,95,81,59,22,79,71,8,6409,38664,21719,"Boone County, Arkansas",9,5,17.18184499
116,5011,Bradley County, Arkansas,40.9,11096,736,18,0,18,384,27,357,183,20,163,151,53,98,3163,34665,20465,"Bradley County, Arkansas",11,5,28.50576784
117,5013,Calhoun County, Arkansas,44.9,5210,31,0,0,0,22,22,0,0,0,0,9,0,9,969,35446,21093,"Calhoun County, Arkansas",13,5,18.59884837
118,5015,Carroll County, Arkansas,44.4,27690,2289,326,55,271,950,332,618,586,167,419,427,260,167,4789,38145,20888,"Carroll County, Arkansas",15,5,17.29505237
119,5017,Chicot County, Arkansas,43.7,11189,286,66,0,66,64,21,43,101,14,87,55,38,17,3252,29628,18853,"Chicot County, Arkansas",17,5,29.06425954
120,5019,Clark County, Arkansas,33.6,22684,657,131,3,128,216,143,73,184,68,116,126,101,25,4762,35595,19500,"Clark County, Arkansas",19,5,20.99277023
121,5021,Clay County, Arkansas,44,15202,207,0,0,0,43,18,25,82,64,18,82,73,9,3340,32404,19192,"Clay County, Arkansas",21,5,21.97079332
122,5023,Cleburne County, Arkansas,47.9,25587,355,30,0,30,70,16,54,113,17,96,142,129,13,3901,41717,25078,"Cleburne County, Arkansas",23,5,15.24602337
123,5025,Cleveland County, Arkansas,42.5,8421,144,0,0,0,80,11,69,6,0,6,58,31,27,1671,42429,21485,"Cleveland County, Arkansas",25,5,19.84324902
124,5027,Columbia County, Arkansas,36,24168,639,185,0,185,179,12,167,82,3,79,193,121,72,5581,36507,19922,"Columbia County, Arkansas",27,5,23.09251903
125,5029,Conway County, Arkansas,41,21060,431,24,0,24,132,42,90,187,32,155,88,40,48,4482,38266,21896,"Conway County, Arkansas",29,5,21.28205128
126,5031,Craighead County, Arkansas,33.9,102884,3906,1061,27,1034,1285,150,1135,759,414,345,801,527,274,18682,43892,24226,"Craighead County, Arkansas",31,5,18.15831422
127,5033,Crawford County, Arkansas,38.8,61927,2604,321,44,277,784,202,582,760,284,476,739,498,241,11491,41792,20889,"Crawford County, Arkansas",33,5,18.55571883
128,5035,Crittenden County, Arkansas,34.7,49511,763,87,0,87,180,22,158,275,127,148,221,77,144,11991,39407,20133,"Crittenden County, Arkansas",35,5,24.21886046
129,5037,Cross County, Arkansas,40.3,17329,86,8,0,8,16,6,10,23,14,9,39,31,8,3364,39306,20692,"Cross County, Arkansas",37,5,19.41254544
130,5039,Dallas County, Arkansas,43.4,7738,187,69,69,0,49,3,46,9,9,0,60,41,19,1054,35745,17803,"Dallas County, Arkansas",39,5,13.62109072
131,5041,Desha County, Arkansas,39.3,12234,327,14,0,14,158,7,151,59,38,21,96,24,72,3859,26519,17324,"Desha County, Arkansas",41,5,31.54324015
132,5043,Drew County, Arkansas,36.8,18688,207,16,0,16,79,7,72,66,28,38,46,46,0,4851,33092,18373,"Drew County, Arkansas",43,5,25.9578339
133,5045,Faulkner County, Arkansas,31.9,120417,3456,598,17,581,1561,345,1216,568,246,322,729,468,261,18590,50872,24809,"Faulkner County, Arkansas",45,5,15.43801955
134,5047,Franklin County, Arkansas,41,17799,380,13,2,11,168,157,11,37,31,6,162,150,12,3684,39482,19811,"Franklin County, Arkansas",47,5,20.69779201
135,5049,Fulton County, Arkansas,48.2,12186,102,40,0,40,0,0,0,0,0,0,62,19,43,2769,35593,19082,"Fulton County, Arkansas",49,5,22.72279665
136,5051,Garland County, Arkansas,44.1,97119,3417,357,13,344,953,131,822,659,306,353,1448,1095,353,19639,40011,24602,"Garland County, Arkansas",51,5,20.22158383
137,5053,Grant County, Arkansas,39.3,18046,157,2,1,1,63,0,63,37,7,30,55,51,4,2318,49195,24696,"Grant County, Arkansas",53,5,12.84495179
138,5055,Greene County, Arkansas,38.2,43745,337,74,0,74,132,12,120,116,58,58,15,5,10,7621,42755,21643,"Greene County, Arkansas",55,5,17.42141959
139,5057,Hempstead County, Arkansas,38.5,22208,1520,104,0,104,572,30,542,619,82,537,225,117,108,5861,34072,17813,"Hempstead County, Arkansas",57,5,26.39139049
140,5059,Hot Spring County, Arkansas,40.9,33440,357,48,0,48,131,64,67,31,0,31,147,78,69,5347,42589,20522,"Hot Spring County, Arkansas",59,5,15.98983254
141,5061,Howard County, Arkansas,38.6,13487,737,89,0,89,173,11,162,323,49,274,152,64,88,2605,34672,22587,"Howard County, Arkansas",61,5,19.31489583
142,5063,Independence County, Arkansas,39.2,37030,1191,221,116,105,445,147,298,268,173,95,257,193,64,6891,37592,22035,"Independence County, Arkansas",63,5,18.60923575
143,5065,Izard County, Arkansas,48.1,13461,297,56,0,56,88,3,85,22,5,17,131,82,49,2775,35188,18964,"Izard County, Arkansas",65,5,20.61511032
144,5067,Jackson County, Arkansas,40.8,17495,127,2,0,2,42,0,42,24,14,10,59,46,13,3866,31245,18316,"Jackson County, Arkansas",67,5,22.09774221
145,5069,Jefferson County, Arkansas,38.7,72385,1236,206,27,179,335,75,260,239,105,134,456,294,162,16959,36377,19691,"Jefferson County, Arkansas",69,5,23.4288872
146,5071,Johnson County, Arkansas,38,26025,2013,163,0,163,745,84,661,771,155,616,334,152,182,5418,34031,18871,"Johnson County, Arkansas",71,5,20.8184438
147,5073,Lafayette County, Arkansas,45.3,7127,69,27,10,17,8,4,4,16,7,9,18,15,3,1830,29882,24171,"Lafayette County, Arkansas",73,5,25.67700295
148,5075,Lawrence County, Arkansas,41.8,16915,103,25,0,25,9,0,9,46,0,46,23,23,0,3840,33381,18010,"Lawrence County, Arkansas",75,5,22.70174401
149,5077,Lee County, Arkansas,40.9,9781,56,0,0,0,0,0,0,9,0,9,47,38,9,2447,25724,14292,"Lee County, Arkansas",77,5,25.01789183
150,5079,Lincoln County, Arkansas,37.6,13935,300,121,0,121,58,0,58,51,0,51,70,25,45,2158,32369,12610,"Lincoln County, Arkansas",79,5,15.48618586
151,5081,Little River County, Arkansas,41.6,12616,94,0,0,0,6,0,6,0,0,0,88,81,7,2384,35396,20237,"Little River County, Arkansas",81,5,18.89663919
152,5083,Logan County, Arkansas,42.8,21935,506,185,6,179,34,18,16,70,26,44,217,201,16,4071,36463,20340,"Logan County, Arkansas",83,5,18.55937999
153,5085,Lonoke County, Arkansas,35.8,71279,1511,220,29,191,463,221,242,344,209,135,484,308,176,8535,56156,24501,"Lonoke County, Arkansas",85,5,11.97407371
154,5087,Madison County, Arkansas,42.3,15761,430,42,0,42,135,36,99,111,0,111,142,107,35,2823,39839,22637,"Madison County, Arkansas",87,5,17.91130004
155,5089,Marion County, Arkansas,51.5,16404,189,39,12,27,30,3,27,44,31,13,76,54,22,3220,33726,18706,"Marion County, Arkansas",89,5,19.62935869
156,5091,Miller County, Arkansas,37.6,43666,517,52,3,49,184,60,124,109,54,55,172,140,32,8749,39955,21217,"Miller County, Arkansas",91,5,20.03618376
157,5093,Mississippi County, Arkansas,35.9,44199,815,248,11,237,258,36,222,157,99,58,152,87,65,11057,35003,19159,"Mississippi County, Arkansas",93,5,25.01640309
158,5095,Monroe County, Arkansas,45.5,7542,85,0,0,0,25,10,15,13,6,7,47,31,16,2139,31541,19849,"Monroe County, Arkansas",95,5,28.36117741
159,5097,Montgomery County, Arkansas,49.2,9100,220,50,0,50,97,17,80,51,7,44,22,22,0,1677,35103,20375,"Montgomery County, Arkansas",97,5,18.42857143
160,5099,Nevada County, Arkansas,44,8668,97,0,0,0,23,23,0,22,22,0,52,24,28,2615,30750,17595,"Nevada County, Arkansas",99,5,30.16843563
161,5101,Newton County, Arkansas,47.9,7988,70,5,0,5,27,0,27,19,19,0,19,19,0,1713,33176,17790,"Newton County, Arkansas",101,5,21.444667
162,5103,Ouachita County, Arkansas,42.8,24728,227,30,0,30,90,0,90,41,13,28,66,32,34,5970,31233,20033,"Ouachita County, Arkansas",103,5,24.14267227
163,5105,Perry County, Arkansas,43.7,10246,59,11,0,11,0,0,0,0,0,0,48,34,14,1804,45819,22474,"Perry County, Arkansas",105,5,17.60687097
164,5107,Phillips County, Arkansas,37.3,19929,126,17,0,17,42,0,42,0,0,0,67,58,9,6588,26829,16684,"Phillips County, Arkansas",107,5,33.05735361
165,5109,Pike County, Arkansas,41.4,11017,475,41,0,41,163,28,135,167,22,145,104,50,54,1997,34519,19686,"Pike County, Arkansas",109,5,18.12653172
166,5111,Poinsett County, Arkansas,39.9,24131,228,73,0,73,79,0,79,41,23,18,35,23,12,5238,35163,17710,"Poinsett County, Arkansas",111,5,21.70651859
167,5113,Polk County, Arkansas,44.1,20290,756,84,12,72,200,8,192,236,47,189,236,147,89,5069,33202,18097,"Polk County, Arkansas",113,5,24.98275012
168,5115,Pope County, Arkansas,34.9,63107,2990,390,1,389,821,105,716,913,210,703,866,417,449,11620,40534,20912,"Pope County, Arkansas",115,5,18.41317128
169,5117,Prairie County, Arkansas,45.4,8334,2,0,0,0,0,0,0,0,0,0,2,0,2,1617,37500,21035,"Prairie County, Arkansas",117,5,19.4024478
170,5119,Pulaski County, Arkansas,36.5,391806,20279,4095,123,3972,8936,2740,6196,3836,1861,1975,3412,2534,878,69467,47101,28421,"Pulaski County, Arkansas",119,5,17.72994798
171,5121,Randolph County, Arkansas,42.9,17584,149,4,0,4,82,16,66,34,28,6,29,29,0,3357,36318,20059,"Randolph County, Arkansas",121,5,19.09121929
172,5123,St. Francis County, Arkansas,38,27023,715,201,15,186,261,6,255,136,54,82,117,74,43,5761,35066,16540,"St. Francis County, Arkansas",123,5,21.31887651
173,5125,Saline County, Arkansas,39.2,115577,3240,375,112,263,1033,296,737,829,457,372,1003,664,339,9706,57632,26963,"Saline County, Arkansas",125,5,8.397864627
174,5127,Scott County, Arkansas,42,10661,474,4,0,4,19,8,11,230,102,128,221,124,97,2204,37861,17934,"Scott County, Arkansas",127,5,20.67348279
175,5129,Searcy County, Arkansas,47.5,7938,63,27,0,27,0,0,0,0,0,0,36,36,0,1619,35542,20618,"Searcy County, Arkansas",129,5,20.39556563
176,5131,Sebastian County, Arkansas,37.1,127351,12072,927,12,915,3672,594,3078,3585,1481,2104,3888,2668,1220,27745,40023,23383,"Sebastian County, Arkansas",131,5,21.78624432
177,5133,Sevier County, Arkansas,35.2,17193,2943,131,25,106,1238,91,1147,999,147,852,575,259,316,3804,38956,17458,"Sevier County, Arkansas",133,5,22.12528355
178,5135,Sharp County, Arkansas,47.9,17027,156,44,0,44,73,6,67,0,0,0,39,29,10,3711,31068,19404,"Sharp County, Arkansas",135,5,21.7947965
179,5137,Stone County, Arkansas,49.1,12503,44,0,0,0,21,10,11,0,0,0,23,23,0,2925,30486,19616,"Stone County, Arkansas",137,5,23.39438535
180,5139,Union County, Arkansas,39.5,40334,852,25,0,25,467,85,382,198,33,165,162,123,39,8220,39836,22240,"Union County, Arkansas",139,5,20.37982843
181,5141,Van Buren County, Arkansas,47.2,16892,318,37,0,37,22,0,22,78,22,56,181,147,34,3084,34576,19883,"Van Buren County, Arkansas",141,5,18.25716315
182,5143,Washington County, Arkansas,31.4,219930,24718,4014,57,3957,9341,1080,8261,7092,1901,5191,4271,2089,2182,40272,45442,25249,"Washington County, Arkansas",143,5,18.31128086
183,5145,White County, Arkansas,36.1,78823,1968,410,30,380,651,90,561,509,230,279,398,232,166,13201,42197,22510,"White County, Arkansas",145,5,16.7476498
184,5147,Woodruff County, Arkansas,43.8,6873,50,0,0,0,0,0,0,0,0,0,50,10,40,1622,30383,18382,"Woodruff County, Arkansas",147,5,23.59959261
185,5149,Yell County, Arkansas,39.3,21716,2295,92,17,75,803,82,721,663,185,478,737,198,539,3738,39323,18981,"Yell County, Arkansas",149,5,17.21311475
186,6001,Alameda County, California,37.2,1605217,508761,64592,3933,60659,144374,45636,98738,126027,78324,47703,173768,142207,31561,189590,79831,39042,"Alameda County, California",1,6,11.8108642
187,6003,Alpine County, California,42.8,1184,37,11,0,11,0,0,0,8,8,0,18,13,5,221,62375,26783,"Alpine County, California",3,6,18.66554054
188,6005,Amador County, California,50.3,36963,2254,108,0,108,429,130,299,259,107,152,1458,984,474,3684,57032,27496,"Amador County, California",5,6,9.96672348
189,6007,Butte County, California,36.9,223877,17501,1952,96,1856,3897,1347,2550,3809,1803,2006,7843,5847,1996,46456,44366,25077,"Butte County, California",7,6,20.75068006
190,6009,Calaveras County, California,51.2,44787,2653,222,119,103,470,74,396,523,201,322,1438,942,496,5641,53502,30577,"Calaveras County, California",9,6,12.59517271
191,6011,Colusa County, California,34.7,21361,5334,227,0,227,1003,197,806,1755,571,1184,2349,1276,1073,2859,54946,25745,"Colusa County, California",11,6,13.38420486
192,6013,Contra Costa County, California,39.1,1107925,270315,26290,2359,23931,73415,21699,51716,66418,35782,30636,104192,83236,20956,111922,82881,40792,"Contra Costa County, California",13,6,10.10194733
193,6015,Del Norte County, California,38.1,27628,1563,39,2,37,270,82,188,223,36,187,1031,708,323,5219,42363,20282,"Del Norte County, California",15,6,18.89025626
194,6017,El Dorado County, California,45.2,183000,17160,1190,182,1008,4335,1146,3189,3774,1952,1822,7861,5978,1883,17839,72586,37089,"El Dorado County, California",17,6,9.748087432
195,6019,Fresno County, California,31.6,963160,205766,15285,1495,13790,54154,11644,42510,51876,16694,35182,84451,48190,36261,254872,45963,21057,"Fresno County, California",19,6,26.46206238
196,6021,Glenn County, California,36.9,27976,5319,153,4,149,1469,206,1263,1636,401,1235,2061,1045,1016,5578,41699,20362,"Glenn County, California",21,6,19.93851873
197,6023,Humboldt County, California,37.6,135182,7196,437,58,379,1856,312,1544,2067,874,1193,2836,1968,868,27641,42685,24038,"Humboldt County, California",23,6,20.44724889
198,6025,Imperial County, California,32.2,178807,56941,4891,546,4345,13222,4198,9024,11504,4919,6585,27324,17123,10201,40552,42560,16311,"Imperial County, California",25,6,22.6792016
199,6027,Inyo County, California,45.4,18326,1756,86,7,79,456,23,433,418,190,228,796,525,271,1905,47278,28678,"Inyo County, California",27,6,10.39506712
200,6029,Kern County, California,31.2,871337,176647,12758,926,11832,43404,7615,35789,50792,13506,37286,69693,36276,33417,194354,49788,21094,"Kern County, California",29,6,22.30526191
201,6031,Kings County, California,31.4,150261,27620,1552,136,1416,6617,1136,5481,6983,1803,5180,12468,6047,6421,28661,47241,19123,"Kings County, California",31,6,19.07414432
202,6033,Lake County, California,45.8,64076,5764,214,17,197,1546,231,1315,1544,641,903,2460,1599,861,15561,36132,21799,"Lake County, California",33,6,24.2852238
203,6035,Lassen County, California,36.4,31945,1925,75,8,67,437,27,410,493,111,382,920,357,563,3558,51457,20072,"Lassen County, California",35,6,11.13789325
204,6037,Los Angeles County, California,35.8,10057155,3474305,264383,23548,240835,774329,198517,575812,827774,363599,464175,1607819,1148789,459030,1764081,57952,29301,"Los Angeles County, California",37,6,17.54055695
205,6039,Madera County, California,33.5,153366,32967,1651,166,1485,9021,967,8054,9326,2101,7225,12969,5623,7346,32043,45742,19021,"Madera County, California",39,6,20.89315754
206,6041,Marin County, California,45.7,259358,47660,4595,122,4473,13296,2529,10767,11543,5086,6457,18226,14423,3803,20445,100310,63608,"Marin County, California",41,6,7.882926303
207,6043,Mariposa County, California,50.6,17645,1243,76,0,76,444,59,385,120,77,43,603,400,203,2849,49265,27832,"Mariposa County, California",43,6,16.14621706
208,6045,Mendocino County, California,42.3,87409,11005,574,79,495,3294,429,2865,2889,684,2205,4248,2701,1547,17366,43510,25278,"Mendocino County, California",45,6,19.86751936
209,6047,Merced County, California,30.6,265001,67438,3314,478,2836,17368,3351,14017,17242,4860,12382,29514,16773,12741,62661,44397,19130,"Merced County, California",47,6,23.64557115
210,6049,Modoc County, California,47.1,9033,565,21,0,21,214,25,189,106,0,106,224,88,136,1483,41194,21899,"Modoc County, California",49,6,16.41757998
211,6051,Mono County, California,38.9,14051,2382,366,0,366,866,7,859,527,96,431,623,324,299,1222,58937,31059,"Mono County, California",51,6,8.696889901
212,6053,Monterey County, California,33.7,430201,129153,9028,519,8509,39186,4326,34860,35861,7650,28211,45078,23426,21652,66289,60889,25947,"Monterey County, California",53,6,15.40884377
213,6055,Napa County, California,40.7,140823,32170,1752,147,1605,9084,1668,7416,8738,3176,5562,12596,8746,3850,12086,74609,38057,"Napa County, California",55,6,8.582404863
214,6057,Nevada County, California,49.5,98639,6259,452,25,427,1483,334,1149,1297,635,662,3027,2217,810,11835,57429,33385,"Nevada County, California",57,6,11.99829682
215,6059,Orange County, California,37.3,3132211,951475,79200,7178,72022,224421,62800,161621,247422,123537,123885,400432,299000,101432,385556,78145,35939,"Orange County, California",59,6,12.30938784
216,6061,Placer County, California,41.5,370571,38729,3151,309,2842,10260,4062,6198,8969,5365,3604,16349,13414,2935,31932,76926,37914,"Placer County, California",61,6,8.616972186
217,6063,Plumas County, California,51.7,18754,773,46,0,46,206,2,204,162,51,111,359,204,155,2346,50125,31292,"Plumas County, California",63,6,12.50933134
218,6065,Riverside County, California,34.8,2323892,508459,32169,2773,29396,108049,25280,82769,121125,47905,73220,247116,157777,89339,376689,57972,24443,"Riverside County, California",65,6,16.20940216
219,6067,Sacramento County, California,35.7,1479300,303371,30784,2814,27970,85580,34324,51256,79308,49558,29750,107699,84353,23346,260877,57509,28292,"Sacramento County, California",67,6,17.63516528
220,6069,San Benito County, California,35.1,58051,11382,405,54,351,2847,507,2340,2607,742,1865,5523,3217,2306,6224,73814,27848,"San Benito County, California",69,6,10.72160686
221,6071,San Bernardino County, California,32.7,2106754,448996,25235,2091,23144,92740,21482,71258,109748,43873,65875,221273,147465,73808,392195,54469,21857,"San Bernardino County, California",71,6,18.61607952
222,6073,San Diego County, California,35.3,3253356,765533,85685,7587,78098,187793,61710,126083,181355,94149,87206,310700,220999,89701,444024,66529,32482,"San Diego County, California",73,6,13.6481836
223,6075,San Francisco County, California,38.4,850282,296849,37204,2654,34550,70927,26197,44730,66084,47155,18929,122634,106852,15782,104180,87701,55567,"San Francisco County, California",75,6,12.25240567
224,6077,San Joaquin County, California,33.7,714860,166244,12390,1118,11272,42579,11871,30708,43096,18768,24328,68179,45350,22829,124587,55045,23477,"San Joaquin County, California",77,6,17.42816775
225,6079,San Luis Obispo County, California,39,278680,29083,2356,145,2211,7374,1490,5884,6841,2552,4289,12512,8794,3718,37208,64014,32335,"San Luis Obispo County, California",79,6,13.35151428
226,6081,San Mateo County, California,39.5,754748,260576,27959,1795,26164,64330,18249,46081,62232,37389,24843,106055,88509,17546,57490,98546,50262,"San Mateo County, California",81,6,7.617111937
227,6083,Santa Barbara County, California,33.7,439395,101014,10993,515,10478,28145,3494,24651,22937,6523,16414,38939,23592,15347,66880,65161,31098,"Santa Barbara County, California",83,6,15.22092878
228,6085,Santa Clara County, California,36.8,1885056,717570,106491,5957,100534,193714,58811,134903,186686,121646,65040,230679,194080,36599,172213,101173,46034,"Santa Clara County, California",85,6,9.135696764
229,6087,Santa Cruz County, California,37,270931,48738,3612,117,3495,12858,2103,10755,12810,4382,8428,19458,11812,7646,39211,70088,34732,"Santa Cruz County, California",87,6,14.47268862
230,6089,Shasta County, California,42.3,179228,8614,1294,29,1265,2018,557,1461,1388,864,524,3914,3124,790,30945,45582,25094,"Shasta County, California",89,6,17.26571741
231,6091,Sierra County, California,55.2,2931,127,0,0,0,0,0,0,77,30,47,50,26,24,329,43984,31873,"Sierra County, California",91,6,11.22483794
232,6093,Siskiyou County, California,47.9,43668,2160,84,36,48,602,180,422,437,144,293,1037,685,352,9524,38524,23542,"Siskiyou County, California",93,6,21.81002107
233,6095,Solano County, California,37.5,429596,86456,6860,815,6045,20645,7927,12718,20126,10597,9529,38825,30116,8709,53265,69227,30251,"Solano County, California",95,6,12.39885846
234,6097,Sonoma County, California,41.2,497776,83650,6320,345,5975,22619,3817,18802,22497,8804,13693,32214,21959,10255,55095,66833,35639,"Sonoma County, California",97,6,11.06823149
235,6099,Stanislaus County, California,33.8,530561,107953,7490,652,6838,26361,6395,19966,26190,9713,16477,47912,29656,18256,95739,51591,22915,"Stanislaus County, California",99,6,18.04486195
236,6101,Sutter County, California,35.6,95406,21553,1812,104,1708,6582,2242,4340,5681,2646,3035,7478,5277,2201,16535,52943,24335,"Sutter County, California",101,6,17.3311951
237,6103,Tehama County, California,40.6,63015,5243,144,35,109,949,201,748,1283,413,870,2867,2042,825,13363,40687,21521,"Tehama County, California",103,6,21.20606205
238,6105,Trinity County, California,50.6,13180,642,13,0,13,37,30,7,107,47,60,485,134,351,2607,35270,22387,"Trinity County, California",105,6,19.77996965
239,6107,Tulare County, California,30.4,455769,102459,5741,326,5415,27014,3305,23709,27440,6166,21274,42264,21364,20900,127130,42789,18257,"Tulare County, California",107,6,27.89351623
240,6109,Tuolumne County, California,48.2,53864,2498,211,23,188,412,94,318,440,264,176,1435,1067,368,7176,50731,29431,"Tuolumne County, California",109,6,13.32244171
241,6111,Ventura County, California,37.3,843110,192397,14473,873,13600,47898,9020,38878,44559,18202,26357,85467,60322,25145,88486,78593,34331,"Ventura County, California",111,6,10.49519043
242,6113,Yolo County, California,30.9,209671,46465,6741,321,6420,13241,4502,8739,12102,6311,5791,14381,10124,4257,38898,57663,28996,"Yolo County, California",113,6,18.55192182
243,6115,Yuba County, California,32.2,73897,8962,614,0,614,2134,416,1718,2659,1137,1522,3555,2689,866,15080,48739,21418,"Yuba County, California",115,6,20.40678241
244,8001,Adams County, Colorado,33.3,479977,73284,7214,563,6651,23276,3792,19484,24614,6350,18264,18180,11638,6542,61265,61444,26051,"Adams County, Colorado",1,8,12.76415328
245,8003,Alamosa County, Colorado,30.2,16353,1303,86,0,86,551,15,536,316,15,301,350,172,178,4786,32385,18133,"Alamosa County, Colorado",3,8,29.2668012
246,8005,Arapahoe County, Colorado,36.3,617668,91044,13242,697,12545,30446,9353,21093,26131,12880,13251,21225,16198,5027,65383,66288,35250,"Arapahoe County, Colorado",5,8,10.58546015
247,8007,Archuleta County, Colorado,49.5,12355,764,77,0,77,257,65,192,143,64,79,287,213,74,1369,45607,28649,"Archuleta County, Colorado",7,8,11.0805342
248,8009,Baca County, Colorado,47.5,3648,117,0,0,0,27,14,13,45,5,40,45,22,23,634,37477,22113,"Baca County, Colorado",9,8,17.37938596
249,8011,Bent County, Colorado,41.2,5816,321,13,0,13,118,0,118,93,12,81,97,49,48,943,34773,13772,"Bent County, Colorado",11,8,16.21389271
250,8013,Boulder County, Colorado,36,313961,33708,6235,249,5986,9740,2580,7160,9038,4111,4927,8695,6689,2006,40732,72282,40097,"Boulder County, Colorado",13,8,12.97358589
251,8014,Broomfield County, Colorado,37.6,62449,5506,652,57,595,1764,479,1285,1345,918,427,1745,1531,214,3667,83334,41698,"Broomfield County, Colorado",14,8,5.871991545
252,8015,Chaffee County, Colorado,49.1,18507,545,34,0,34,90,20,70,139,95,44,282,139,143,1673,50993,27848,"Chaffee County, Colorado",15,8,9.03982277
253,8017,Cheyenne County, Colorado,37.8,2071,145,20,0,20,30,6,24,58,16,42,37,3,34,229,54375,23916,"Cheyenne County, Colorado",17,8,11.05746016
254,8019,Clear Creek County, Colorado,47.6,9238,274,108,0,108,74,23,51,40,9,31,52,33,19,677,68250,42355,"Clear Creek County, Colorado",19,8,7.328426066
255,8021,Conejos County, Colorado,38.7,8213,287,15,2,13,24,4,20,19,5,14,229,108,121,1805,34630,18221,"Conejos County, Colorado",21,8,21.97735298
256,8023,Costilla County, Colorado,50.5,3590,297,62,0,62,45,14,31,72,22,50,118,95,23,1092,26610,20238,"Costilla County, Colorado",23,8,30.4178273
257,8025,Crowley County, Colorado,39.6,5537,314,39,0,39,44,1,43,65,1,64,166,19,147,1479,31719,12513,"Crowley County, Colorado",25,8,26.71121546
258,8027,Custer County, Colorado,56.8,4375,102,0,0,0,0,0,0,31,13,18,71,58,13,772,38605,22333,"Custer County, Colorado",27,8,17.64571429
259,8029,Delta County, Colorado,47.5,30221,1300,73,37,36,358,4,354,309,100,209,560,364,196,4890,42011,24261,"Delta County, Colorado",29,8,16.18080143
260,8031,Denver County, Colorado,34.2,663303,105168,13184,971,12213,36338,7741,28597,29743,9844,19899,25903,16925,8978,106745,56258,36616,"Denver County, Colorado",31,8,16.09294696
261,8033,Dolores County, Colorado,46,1789,24,0,0,0,0,0,0,14,11,3,10,7,3,346,32240,21112,"Dolores County, Colorado",33,8,19.34041364
262,8035,Douglas County, Colorado,37.8,314238,22401,3351,283,3068,6404,2169,4235,5922,4079,1843,6724,5748,976,11807,105759,47062,"Douglas County, Colorado",35,8,3.75734316
263,8037,Eagle County, Colorado,35.9,52894,9634,874,0,874,3326,648,2678,3484,744,2740,1950,859,1091,4237,78763,38604,"Eagle County, Colorado",37,8,8.010360343
264,8039,Elbert County, Colorado,45.4,24225,1068,174,92,82,482,68,414,137,81,56,275,233,42,1221,87288,39360,"Elbert County, Colorado",39,8,5.040247678
265,8041,El Paso County, Colorado,33.8,665171,47203,6217,842,5375,13225,4508,8717,10418,5226,5192,17343,13860,3483,73012,60219,30261,"El Paso County, Colorado",41,8,10.97642561
266,8043,Fremont County, Colorado,44.3,46835,1321,77,34,43,156,52,104,329,110,219,759,404,355,6012,42308,19427,"Fremont County, Colorado",43,8,12.83655386
267,8045,Garfield County, Colorado,36.1,57495,8641,497,11,486,3813,277,3536,2734,446,2288,1597,831,766,6274,61300,29179,"Garfield County, Colorado",45,8,10.91225324
268,8047,Gilpin County, Colorado,44.8,5708,249,7,0,7,15,15,0,48,22,26,179,121,58,392,67544,37027,"Gilpin County, Colorado",47,8,6.86755431
269,8049,Grand County, Colorado,43,14490,1136,93,0,93,183,69,114,300,94,206,560,374,186,1523,67623,32348,"Grand County, Colorado",49,8,10.51069703
270,8051,Gunnison County, Colorado,34.4,15889,503,35,6,29,258,69,189,1,0,1,209,172,37,2319,50746,25920,"Gunnison County, Colorado",51,8,14.59500283
271,8053,Hinsdale County, Colorado,56.4,856,10,0,0,0,2,2,0,2,2,0,6,6,0,96,51250,29958,"Hinsdale County, Colorado",53,8,11.21495327
272,8055,Huerfano County, Colorado,54.5,6521,146,0,0,0,28,6,22,19,5,14,99,99,0,1086,33257,25062,"Huerfano County, Colorado",55,8,16.65388744
273,8057,Jackson County, Colorado,51.2,1306,69,4,0,4,26,6,20,35,0,35,4,4,0,179,45053,26798,"Jackson County, Colorado",57,8,13.70597243
274,8059,Jefferson County, Colorado,40.5,558810,37399,4455,341,4114,10266,3590,6676,9619,4677,4942,13059,10389,2670,44629,72017,38367,"Jefferson County, Colorado",59,8,7.986435461
275,8061,Kiowa County, Colorado,40.7,1465,10,0,0,0,0,0,0,3,0,3,7,2,5,154,38385,21602,"Kiowa County, Colorado",61,8,10.51194539
276,8063,Kit Carson County, Colorado,39.2,8174,701,9,0,9,255,39,216,249,2,247,188,23,165,1033,44449,24327,"Kit Carson County, Colorado",63,8,12.63763151
277,8065,Lake County, Colorado,39.4,7401,756,30,0,30,236,51,185,367,57,310,123,24,99,836,46928,26693,"Lake County, Colorado",65,8,11.29577084
278,8067,La Plata County, Colorado,39,53994,2017,247,16,231,742,203,539,347,183,164,681,484,197,5569,61910,32953,"La Plata County, Colorado",67,8,10.31410898
279,8069,Larimer County, Colorado,35.6,325228,16488,2858,233,2625,4986,1481,3505,4123,1981,2142,4521,3628,893,41640,61942,32433,"Larimer County, Colorado",69,8,12.80332567
280,8071,Las Animas County, Colorado,45.7,14322,656,76,9,67,119,28,91,143,43,100,318,181,137,1926,42808,23857,"Las Animas County, Colorado",71,8,13.44784248
281,8073,Lincoln County, Colorado,37.5,5515,200,14,0,14,76,0,76,35,1,34,75,13,62,597,40438,14210,"Lincoln County, Colorado",73,8,10.82502267
282,8075,Logan County, Colorado,37.1,21862,902,75,0,75,384,40,344,146,33,113,297,95,202,3394,43340,23692,"Logan County, Colorado",75,8,15.52465465
283,8077,Mesa County, Colorado,38.8,148166,5297,297,16,281,1484,445,1039,1435,420,1015,2081,1409,672,23633,50070,26731,"Mesa County, Colorado",77,8,15.95035298
284,8079,Mineral County, Colorado,61.2,793,0,0,0,0,0,0,0,0,0,0,0,0,0,65,49125,35041,"Mineral County, Colorado",79,8,8.196721311
285,8081,Moffat County, Colorado,37.7,13034,821,55,0,55,198,47,151,350,221,129,218,137,81,1419,53664,26344,"Moffat County, Colorado",81,8,10.88691116
286,8083,Montezuma County, Colorado,43.4,26006,673,16,0,16,170,3,167,245,182,63,242,135,107,4811,41622,22738,"Montezuma County, Colorado",83,8,18.49957702
287,8085,Montrose County, Colorado,44.6,40866,2872,156,9,147,884,101,783,1223,549,674,609,385,224,7278,43890,23276,"Montrose County, Colorado",85,8,17.80942593
288,8087,Morgan County, Colorado,36.6,28288,3455,507,38,469,701,159,542,1250,255,995,997,517,480,2986,49495,23408,"Morgan County, Colorado",87,8,10.55571267
289,8089,Otero County, Colorado,40.3,18440,1143,54,2,52,383,76,307,340,84,256,366,203,163,4154,34477,19842,"Otero County, Colorado",89,8,22.52711497
290,8091,Ouray County, Colorado,53.3,4651,138,12,2,10,50,9,41,4,0,4,72,56,16,425,62800,34993,"Ouray County, Colorado",91,8,9.137819824
291,8093,Park County, Colorado,50,16440,690,60,8,52,130,37,93,189,95,94,311,157,154,1022,61675,34442,"Park County, Colorado",93,8,6.216545012
292,8095,Phillips County, Colorado,41,4347,411,47,0,47,153,98,55,173,55,118,38,18,20,509,46955,26290,"Phillips County, Colorado",95,8,11.70922475
293,8097,Pitkin County, Colorado,43.2,17543,2284,429,6,423,735,121,614,699,402,297,421,247,174,1507,69789,59229,"Pitkin County, Colorado",97,8,8.590320926
294,8099,Prowers County, Colorado,37.5,12121,1043,138,20,118,203,26,177,305,31,274,397,184,213,2422,41037,20589,"Prowers County, Colorado",99,8,19.98184968
295,8101,Pueblo County, Colorado,38.8,162158,6135,481,62,419,1695,267,1428,1573,301,1272,2386,1741,645,31907,42000,22431,"Pueblo County, Colorado",101,8,19.67648836
296,8103,Rio Blanco County, Colorado,35.7,6658,231,6,6,0,64,27,37,80,24,56,81,78,3,788,56771,27419,"Rio Blanco County, Colorado",103,8,11.835386
297,8105,Rio Grande County, Colorado,40.8,11623,777,63,0,63,138,22,116,202,91,111,374,204,170,2174,40177,22918,"Rio Grande County, Colorado",105,8,18.70429321
298,8107,Routt County, Colorado,40,23980,1565,499,96,403,540,170,370,293,127,166,233,103,130,2408,63505,36692,"Routt County, Colorado",107,8,10.04170142
299,8109,Saguache County, Colorado,47.5,6255,794,45,9,36,148,35,113,296,25,271,305,214,91,1409,32457,21356,"Saguache County, Colorado",109,8,22.52597922
300,8111,San Juan County, Colorado,49,552,3,0,0,0,0,0,0,0,0,0,3,3,0,21,41250,29427,"San Juan County, Colorado",111,8,3.804347826
301,8113,San Miguel County, Colorado,41.4,7767,617,196,0,196,136,58,78,143,28,115,142,107,35,923,58170,35701,"San Miguel County, Colorado",113,8,11.88361015
302,8115,Sedgwick County, Colorado,49.5,2367,114,5,0,5,8,8,0,47,0,47,54,36,18,342,46977,24247,"Sedgwick County, Colorado",115,8,14.4486692
303,8117,Summit County, Colorado,38.2,29269,3444,623,7,616,1355,327,1028,761,343,418,705,346,359,3522,70192,36545,"Summit County, Colorado",117,8,12.0332092
304,8119,Teller County, Colorado,49.5,23472,686,0,0,0,109,6,103,123,113,10,454,277,177,1752,63723,34230,"Teller County, Colorado",119,8,7.464212679
305,8121,Washington County, Colorado,42.8,4814,115,5,0,5,35,16,19,48,4,44,27,20,7,529,46315,25744,"Washington County, Colorado",121,8,10.98878272
306,8123,Weld County, Colorado,34,278065,24062,2378,218,2160,7356,1623,5733,7665,2331,5334,6663,4057,2606,34050,62820,27808,"Weld County, Colorado",123,8,12.24533832
307,8125,Yuma County, Colorado,37.2,10150,1061,316,0,316,368,13,355,247,127,120,130,102,28,1459,42026,23905,"Yuma County, Colorado",125,8,14.37438424
308,9001,Fairfield County, Connecticut,39.9,941618,199191,25538,1343,24195,64133,15030,49103,46713,23262,23451,62807,49143,13664,81553,86670,51719,"Fairfield County, Connecticut",1,9,8.660943185
309,9003,Hartford County, Connecticut,40.2,895699,134454,19872,1475,18397,36474,12224,24250,29740,19139,10601,48368,39078,9290,100830,68027,36570,"Hartford County, Connecticut",3,9,11.25712991
310,9005,Litchfield County, Connecticut,46.4,185141,13925,1188,46,1142,3350,1389,1961,2901,1587,1314,6486,4809,1677,12706,73519,38859,"Litchfield County, Connecticut",5,9,6.862877483
311,9007,Middlesex County, Connecticut,44.7,164438,12584,1618,151,1467,3012,1073,1939,2524,1609,915,5430,4242,1188,11193,79837,42573,"Middlesex County, Connecticut",7,9,6.806820808
312,9009,New Haven County, Connecticut,39.8,860874,103937,17029,950,16079,27331,8654,18677,24720,14277,10443,34857,27529,7328,106796,62715,33706,"New Haven County, Connecticut",9,9,12.40553205
313,9011,New London County, Connecticut,40.9,272033,22680,2746,192,2554,6391,2407,3984,5268,3669,1599,8275,7160,1115,25645,67574,35531,"New London County, Connecticut",11,9,9.427165087
314,9013,Tolland County, Connecticut,37.8,151689,10268,2249,68,2181,2651,797,1854,2169,1742,427,3199,2729,470,9223,80129,36364,"Tolland County, Connecticut",13,9,6.080203574
315,9015,Windham County, Connecticut,40.7,117078,6170,937,9,928,1724,385,1339,1173,656,517,2336,1756,580,12518,60689,28663,"Windham County, Connecticut",15,9,10.69201729
316,10001,Kent County, Delaware,37.2,171474,9881,1361,85,1276,2672,731,1941,2136,1458,678,3712,3029,683,21866,55184,26118,"Kent County, Delaware",1,10,12.75178744
317,10003,New Castle County, Delaware,37.6,551997,58578,10427,624,9803,20075,6510,13565,13405,8169,5236,14671,12217,2454,60817,66283,33240,"New Castle County, Delaware",3,10,11.01763234
318,10005,Sussex County, Delaware,47.6,211224,14091,1123,89,1034,5298,1037,4261,3320,1213,2107,4350,3409,941,26765,54218,29630,"Sussex County, Delaware",5,10,12.67138204
319,11001,District of Columbia, District of Columbia,33.8,659009,92513,18984,967,18017,30550,8911,21639,17612,9723,7889,25367,18930,6437,112060,72935,48781,"District of Columbia, District of Columbia",1,11,17.00432012
320,12001,Alachua County, Florida,31,256581,26029,6889,265,6624,7102,3313,3789,5503,3654,1849,6535,5340,1195,58387,44702,25758,"Alachua County, Florida",1,12,22.75577693
321,12003,Baker County, Florida,36.5,27312,403,49,0,49,34,0,34,110,45,65,210,156,54,4522,53327,21222,"Baker County, Florida",3,12,16.55682484
322,12005,Bay County, Florida,39.7,178361,9774,1694,218,1476,2796,811,1985,1455,1098,357,3829,2913,916,27363,48577,25695,"Bay County, Florida",5,12,15.34135826
323,12007,Bradford County, Florida,41,26919,621,49,14,35,71,31,40,228,112,116,273,156,117,4559,43373,19852,"Bradford County, Florida",7,12,16.93599316
324,12009,Brevard County, Florida,47,560683,48402,6029,500,5529,9484,3794,5690,9096,5625,3471,23793,20184,3609,77357,49914,28189,"Brevard County, Florida",9,12,13.79692268
325,12011,Broward County, Florida,40,1863780,609749,74298,6752,67546,177346,71315,106031,143760,93828,49932,214345,179671,34674,265521,52954,28987,"Broward County, Florida",11,12,14.24637028
326,12013,Calhoun County, Florida,40.6,14550,517,14,10,4,126,10,116,158,26,132,219,151,68,1623,37089,16560,"Calhoun County, Florida",13,12,11.15463918
327,12015,Charlotte County, Florida,57.7,169642,17279,1952,47,1905,3039,1144,1895,2695,1686,1009,9593,7691,1902,20511,44865,27860,"Charlotte County, Florida",15,12,12.09075583
328,12017,Citrus County, Florida,55.7,140453,7604,553,48,505,1384,554,830,1207,766,441,4460,3686,774,24409,39054,24188,"Citrus County, Florida",17,12,17.37876727
329,12019,Clay County, Florida,39.4,200346,14182,1555,90,1465,3136,1793,1343,3683,2396,1287,5808,5094,714,20243,59179,27159,"Clay County, Florida",19,12,10.10402005
330,12021,Collier County, Florida,49.2,348236,82939,11478,890,10588,28154,7504,20650,19632,9425,10207,23675,17350,6325,45375,59783,39616,"Collier County, Florida",21,12,13.0299567
331,12023,Columbia County, Florida,40.7,68198,2478,160,27,133,707,183,524,539,335,204,1072,720,352,12229,42848,21875,"Columbia County, Florida",23,12,17.9316109
332,12027,DeSoto County, Florida,40.2,35134,6150,1184,0,1184,1847,201,1646,1273,528,745,1846,897,949,9920,35513,16710,"DeSoto County, Florida",27,12,28.23475835
333,12029,Dixie County, Florida,46.3,16084,448,2,0,2,98,0,98,15,2,13,333,258,75,3109,34634,18490,"Dixie County, Florida",29,12,19.32976871
334,12031,Duval County, Florida,36,900890,87582,14534,853,13681,27654,10971,16683,18768,13064,5704,26626,22325,4301,146252,49196,27235,"Duval County, Florida",31,12,16.23416843
335,12033,Escambia County, Florida,37.1,309574,14697,2563,178,2385,3605,1093,2512,2586,1570,1016,5943,4946,997,42672,46117,24532,"Escambia County, Florida",33,12,13.78410332
336,12035,Flagler County, Florida,50.1,102917,12115,774,0,774,1687,737,950,2879,2133,746,6775,5878,897,13453,48898,25314,"Flagler County, Florida",35,12,13.07169855
337,12037,Franklin County, Florida,43.8,11705,379,26,0,26,136,23,113,90,49,41,127,78,49,2060,40301,21515,"Franklin County, Florida",37,12,17.59931653
338,12039,Gadsden County, Florida,40.3,46153,2378,182,25,157,810,89,721,750,304,446,636,418,218,11042,38533,18187,"Gadsden County, Florida",39,12,23.92477195
339,12041,Gilchrist County, Florida,42.3,17033,495,21,0,21,168,11,157,49,35,14,257,156,101,3730,40881,21620,"Gilchrist County, Florida",41,12,21.89866729
340,12043,Glades County, Florida,45.1,13420,1643,107,0,107,402,14,388,440,16,424,694,385,309,2500,34143,17798,"Glades County, Florida",43,12,18.62891207
341,12045,Gulf County, Florida,44.5,15851,312,20,0,20,86,33,53,42,8,34,164,112,52,2068,40822,20050,"Gulf County, Florida",45,12,13.04649549
342,12047,Hamilton County, Florida,40.9,14362,523,7,4,3,204,22,182,147,14,133,165,52,113,2963,38980,15970,"Hamilton County, Florida",47,12,20.63083136
343,12049,Hardee County, Florida,34.3,27302,3962,181,10,171,1197,228,969,1128,328,800,1456,688,768,6716,36222,17179,"Hardee County, Florida",49,12,24.59893048
344,12051,Hendry County, Florida,33.8,38376,10480,1739,25,1714,2754,473,2281,2867,724,2143,3120,1750,1370,9776,37552,18027,"Hendry County, Florida",51,12,25.47425474
345,12053,Hernando County, Florida,48.9,176797,12020,1084,294,790,1748,632,1116,1832,1107,725,7356,6107,1249,27175,42274,22435,"Hernando County, Florida",53,12,15.37073593
346,12055,Highlands County, Florida,52.6,98862,10937,1857,49,1808,2281,523,1758,2436,711,1725,4363,3038,1325,18889,35865,21916,"Highlands County, Florida",55,12,19.10643119
347,12057,Hillsborough County, Florida,36.6,1323059,213338,33295,1876,31419,64136,20689,43447,50874,29229,21645,65033,52032,13001,213566,51681,28727,"Hillsborough County, Florida",57,12,16.14183494
348,12059,Holmes County, Florida,42.3,19569,340,4,1,3,97,11,86,33,9,24,206,86,120,4571,37437,17854,"Holmes County, Florida",59,12,23.35837294
349,12061,Indian River County, Florida,51.4,145342,14832,1579,170,1409,3864,1067,2797,2722,1381,1341,6667,5164,1503,20302,47446,32208,"Indian River County, Florida",61,12,13.96843308
350,12063,Jackson County, Florida,41.3,48721,1643,251,0,251,456,53,403,446,203,243,490,249,241,9325,35470,17222,"Jackson County, Florida",63,12,19.13959073
351,12065,Jefferson County, Florida,45.5,14082,416,7,0,7,76,0,76,128,5,123,205,132,73,1825,41696,21311,"Jefferson County, Florida",65,12,12.95980685
352,12067,Lafayette County, Florida,38.4,8742,378,28,0,28,114,5,109,137,8,129,99,13,86,1272,36236,19341,"Lafayette County, Florida",67,12,14.55044612
353,12069,Lake County, Florida,46.7,317586,25527,2265,197,2068,5434,2095,3339,6248,3508,2740,11580,9536,2044,42342,47141,24760,"Lake County, Florida",69,12,13.33245168
354,12071,Lee County, Florida,47.3,680970,106476,14798,1181,13617,33571,10185,23386,24610,11469,13141,33497,25588,7909,104219,50390,28949,"Lee County, Florida",71,12,15.30449212
355,12073,Leon County, Florida,30.3,284788,19831,3632,129,3503,7025,2442,4583,3938,2640,1298,5236,4335,901,58148,48248,27190,"Leon County, Florida",73,12,20.41799514
356,12075,Levy County, Florida,46.6,39707,1394,40,10,30,447,43,404,287,120,167,620,486,134,8652,35480,20555,"Levy County, Florida",75,12,21.78960889
357,12077,Liberty County, Florida,36.9,8285,409,2,0,2,158,29,129,97,13,84,152,105,47,1147,37917,17218,"Liberty County, Florida",77,12,13.84429692
358,12079,Madison County, Florida,41.6,18560,682,91,0,91,119,32,87,104,25,79,368,195,173,4703,29806,16486,"Madison County, Florida",79,12,25.33943966
359,12081,Manatee County, Florida,47.1,353411,43127,6627,510,6117,13365,3265,10100,9534,4570,4964,13601,9940,3661,50094,51483,29140,"Manatee County, Florida",81,12,14.17443147
360,12083,Marion County, Florida,48.5,340341,24426,1894,156,1738,5561,2378,3183,4555,2962,1593,12416,9562,2854,60266,40295,22390,"Marion County, Florida",83,12,17.7075345
361,12085,Martin County, Florida,51.1,153592,15555,1220,90,1130,4986,963,4023,2909,1015,1894,6440,4795,1645,17758,52622,35892,"Martin County, Florida",85,12,11.56180009
362,12086,Miami-Dade County, Florida,39.3,2664418,1391622,192737,13595,179142,402184,153064,249120,291699,183546,108153,505002,419580,85422,522143,44224,24515,"Miami-Dade County, Florida",86,12,19.59688758
363,12087,Monroe County, Florida,46.7,77150,13742,1806,135,1671,4194,1319,2875,2863,1586,1277,4879,3909,970,9815,60303,36771,"Monroe County, Florida",87,12,12.72197019
364,12089,Nassau County, Florida,44.6,77187,2514,185,36,149,485,68,417,555,333,222,1289,1131,158,9702,59196,31141,"Nassau County, Florida",89,12,12.56947413
365,12091,Okaloosa County, Florida,36.8,195798,12825,1544,195,1349,3324,1165,2159,2824,1781,1043,5133,4184,949,22821,57655,29603,"Okaloosa County, Florida",91,12,11.65537952
366,12093,Okeechobee County, Florida,40.2,39420,4766,474,14,460,1043,126,917,1589,310,1279,1660,975,685,9105,36415,17173,"Okeechobee County, Florida",93,12,23.09741248
367,12095,Orange County, Florida,34.5,1256055,253187,42493,4058,38435,77066,27938,49128,61249,35308,25941,72379,58349,14030,212105,49391,26210,"Orange County, Florida",95,12,16.8866013
368,12097,Osceola County, Florida,35.8,311962,59795,8792,1197,7595,15885,5453,10432,13913,7925,5988,21205,16884,4321,60243,45536,19482,"Osceola County, Florida",97,12,19.31100583
369,12099,Palm Beach County, Florida,44.3,1398757,333024,45144,4592,40552,103182,33771,69411,74971,42971,32000,109727,87997,21730,191207,55277,34846,"Palm Beach County, Florida",99,12,13.66977967
370,12101,Pasco County, Florida,44.6,488310,45117,4713,349,4364,11198,4787,6411,9716,6365,3351,19490,15340,4150,65101,46010,25225,"Pasco County, Florida",101,12,13.33189982
371,12103,Pinellas County, Florida,47.4,939548,107716,13624,1133,12491,26478,10571,15907,25416,16666,8750,42198,34111,8087,130727,47090,31035,"Pinellas County, Florida",103,12,13.91381813
372,12105,Polk County, Florida,40.4,637691,62942,6848,606,6242,20594,5541,15053,14475,6480,7995,21025,14852,6173,110225,44146,21669,"Polk County, Florida",105,12,17.28501735
373,12107,Putnam County, Florida,44.5,72304,3052,129,3,126,1315,176,1139,610,194,416,998,645,353,19120,33003,18561,"Putnam County, Florida",107,12,26.44390352
374,12109,St. Johns County, Florida,42.9,218362,15037,1563,137,1426,3619,1644,1975,3027,1962,1065,6828,6061,767,19372,69523,38362,"St. Johns County, Florida",109,12,8.871506947
375,12111,St. Lucie County, Florida,44.3,293136,47279,4872,343,4529,12351,4165,8186,9677,4939,4738,20379,16822,3557,51945,44140,24104,"St. Lucie County, Florida",111,12,17.72044375
376,12113,Santa Rosa County, Florida,39.5,163903,7332,531,42,489,1640,747,893,1768,904,864,3393,2760,633,19331,60652,28219,"Santa Rosa County, Florida",113,12,11.79417094
377,12115,Sarasota County, Florida,54.5,398011,48738,6101,466,5635,12233,4175,8058,9557,4961,4596,20847,16779,4068,43281,52796,35210,"Sarasota County, Florida",115,12,10.87432257
378,12117,Seminole County, Florida,39.2,442905,54679,6764,857,5907,14334,6846,7488,12479,8941,3538,21102,17657,3445,53025,58538,30097,"Seminole County, Florida",117,12,11.97209334
379,12119,Sumter County, Florida,66,113589,5873,409,0,409,809,130,679,765,462,303,3890,3136,754,10343,52594,31591,"Sumter County, Florida",119,12,9.105635229
380,12121,Suwannee County, Florida,41.9,43653,2486,112,18,94,996,122,874,833,223,610,545,381,164,9536,37796,19322,"Suwannee County, Florida",121,12,21.84500493
381,12123,Taylor County, Florida,41.3,22582,643,24,0,24,160,91,69,130,43,87,329,236,93,2746,36195,16081,"Taylor County, Florida",123,12,12.16012754
382,12125,Union County, Florida,39.7,15159,438,30,0,30,92,0,92,134,44,90,182,32,150,2232,37778,12943,"Union County, Florida",125,12,14.72392638
383,12127,Volusia County, Florida,46.5,510806,37562,4873,605,4268,7840,3002,4838,7622,4343,3279,17227,14053,3174,83660,42240,24834,"Volusia County, Florida",127,12,16.37803785
384,12129,Wakulla County, Florida,40.2,31314,617,54,0,54,131,58,73,98,43,55,334,212,122,3970,54078,22129,"Wakulla County, Florida",129,12,12.67803538
385,12131,Walton County, Florida,43.4,61528,3544,297,133,164,1077,541,536,708,345,363,1462,1039,423,10357,46910,28475,"Walton County, Florida",131,12,16.83298661
386,12133,Washington County, Florida,42,24627,669,58,27,31,99,16,83,143,43,100,369,284,85,4532,38330,18239,"Washington County, Florida",133,12,18.40256629
387,13001,Appling County, Georgia,38.8,18410,806,56,0,56,251,108,143,382,63,319,117,69,48,3694,37388,19607,"Appling County, Georgia",1,13,20.06518197
388,13003,Atkinson County, Georgia,35.3,8268,1080,70,0,70,441,41,400,332,102,230,237,107,130,2270,31296,19002,"Atkinson County, Georgia",3,13,27.45524915
389,13005,Bacon County, Georgia,36.9,11251,527,9,0,9,287,0,287,74,29,45,157,14,143,1949,37303,18299,"Bacon County, Georgia",5,13,17.32290463
390,13007,Baker County, Georgia,45.9,3250,164,0,0,0,57,0,57,74,16,58,33,33,0,509,45903,23001,"Baker County, Georgia",7,13,15.66153846
391,13009,Baldwin County, Georgia,34.3,45808,1169,162,0,162,296,42,254,524,226,298,187,148,39,12503,34595,19147,"Baldwin County, Georgia",9,13,27.29435906
392,13011,Banks County, Georgia,40.9,18336,889,90,0,90,293,87,206,294,186,108,212,165,47,2837,40721,18890,"Banks County, Georgia",11,13,15.47229494
393,13013,Barrow County, Georgia,35,73340,5065,386,53,333,1503,394,1109,1351,560,791,1825,1161,664,10548,53133,21978,"Barrow County, Georgia",13,13,14.38232888
394,13015,Bartow County, Georgia,37.4,101942,4770,226,19,207,1582,260,1322,2014,158,1856,948,718,230,14899,50565,23376,"Bartow County, Georgia",15,13,14.61517333
395,13017,Ben Hill County, Georgia,39.1,17405,415,18,0,18,93,7,86,222,0,222,82,68,14,5948,29510,15311,"Ben Hill County, Georgia",17,13,34.17408791
396,13019,Berrien County, Georgia,39.2,18986,595,84,73,11,227,36,191,192,40,152,92,39,53,4811,35740,17007,"Berrien County, Georgia",19,13,25.33972401
397,13021,Bibb County, Georgia,35.8,154194,5566,1297,206,1091,1645,431,1214,1257,725,532,1367,1024,343,41075,37108,22175,"Bibb County, Georgia",21,13,26.63852031
398,13023,Bleckley County, Georgia,37.2,12835,173,37,0,37,65,22,43,15,0,15,56,48,8,2593,37060,19511,"Bleckley County, Georgia",23,13,20.20257109
399,13025,Brantley County, Georgia,39.9,18403,156,3,0,3,20,6,14,44,19,25,89,64,25,3846,36837,17320,"Brantley County, Georgia",25,13,20.89876651
400,13027,Brooks County, Georgia,42.6,15645,540,76,0,76,119,4,115,145,0,145,200,66,134,3819,34547,19665,"Brooks County, Georgia",27,13,24.41035475
401,13029,Bryan County, Georgia,34.9,34104,1547,135,0,135,377,126,251,360,180,180,675,481,194,4509,65862,29056,"Bryan County, Georgia",29,13,13.22132301
402,13031,Bulloch County, Georgia,27.4,73141,2541,456,28,428,1096,274,822,543,331,212,446,394,52,20922,37125,19544,"Bulloch County, Georgia",31,13,28.60502317
403,13033,Burke County, Georgia,37.1,22838,469,50,0,50,203,0,203,111,84,27,105,79,26,6862,34589,18667,"Burke County, Georgia",33,13,30.04641387
404,13035,Butts County, Georgia,38.5,23479,701,23,0,23,225,36,189,215,45,170,238,168,70,4255,40753,19529,"Butts County, Georgia",35,13,18.12257762
405,13037,Calhoun County, Georgia,38.4,6443,271,15,0,15,155,20,135,33,4,29,68,58,10,1489,28200,16778,"Calhoun County, Georgia",37,13,23.11035232
406,13039,Camden County, Georgia,31.5,52092,1950,155,56,99,696,185,511,424,247,177,675,425,250,7029,53327,24368,"Camden County, Georgia",39,13,13.49343469
407,13043,Candler County, Georgia,37.6,10962,541,42,14,28,263,17,246,120,34,86,116,41,75,3155,33379,17750,"Candler County, Georgia",43,13,28.7812443
408,13045,Carroll County, Georgia,34.1,113756,4215,686,0,686,1696,336,1360,868,449,419,965,648,317,21157,45486,22002,"Carroll County, Georgia",45,13,18.59857942
409,13047,Catoosa County, Georgia,39.3,65645,1582,186,16,170,392,171,221,431,271,160,573,314,259,7700,52265,23834,"Catoosa County, Georgia",47,13,11.72975855
410,13049,Charlton County, Georgia,41.4,12968,1165,252,0,252,186,0,186,228,0,228,499,86,413,2420,43871,18693,"Charlton County, Georgia",49,13,18.66132017
411,13051,Chatham County, Georgia,34.6,282613,17462,3189,154,3035,6344,1801,4543,3610,1925,1685,4319,3330,989,48550,49596,27204,"Chatham County, Georgia",51,13,17.17896912
412,13053,Chattahoochee County, Georgia,23.1,11882,885,319,24,295,312,186,126,123,98,25,131,114,17,1174,43929,19708,"Chattahoochee County, Georgia",53,13,9.8804915
413,13055,Chattooga County, Georgia,40.3,25046,772,24,0,24,384,15,369,193,32,161,171,114,57,5182,35245,17381,"Chattooga County, Georgia",55,13,20.68993053
414,13057,Cherokee County, Georgia,37.7,230629,20476,2180,85,2095,8041,1886,6155,4978,2041,2937,5277,3727,1550,22891,72586,32002,"Cherokee County, Georgia",57,13,9.925464707
415,13059,Clarke County, Georgia,26.8,122037,12280,2537,77,2460,4933,787,4146,2958,1236,1722,1852,1265,587,39327,33116,20195,"Clarke County, Georgia",59,13,32.2254726
416,13061,Clay County, Georgia,44.1,3068,81,0,0,0,48,48,0,26,26,0,7,7,0,1199,22120,13533,"Clay County, Georgia",61,13,39.08083442
417,13063,Clayton County, Georgia,32.4,270269,38346,4260,605,3655,13418,3400,10018,12099,5626,6473,8569,6180,2389,64326,42470,18728,"Clayton County, Georgia",63,13,23.80073186
418,13065,Clinch County, Georgia,37.2,6814,196,10,4,6,127,0,127,14,7,7,45,45,0,2368,24848,16912,"Clinch County, Georgia",65,13,34.75198122
419,13067,Cobb County, Georgia,36.2,728388,114206,15406,1135,14271,39584,11478,28106,31874,14949,16925,27342,20516,6826,83479,68818,34891,"Cobb County, Georgia",67,13,11.46078738
420,13069,Coffee County, Georgia,35.6,43042,2527,223,25,198,844,211,633,757,266,491,703,330,373,9618,34536,18060,"Coffee County, Georgia",69,13,22.34561591
421,13071,Colquitt County, Georgia,35.8,46002,4876,441,25,416,1799,82,1717,1806,231,1575,830,360,470,11305,33968,17477,"Colquitt County, Georgia",71,13,24.57501848
422,13073,Columbia County, Georgia,36.5,139904,9751,1147,165,982,3175,1225,1950,1915,1171,744,3514,3219,295,13225,71962,31004,"Columbia County, Georgia",73,13,9.452910567
423,13075,Cook County, Georgia,36.5,17103,447,0,0,0,107,15,92,221,24,197,119,75,44,4429,35199,17564,"Cook County, Georgia",75,13,25.89604163
424,13077,Coweta County, Georgia,37.9,135625,7726,948,169,779,2785,733,2052,2146,900,1246,1847,1372,475,16138,65244,29769,"Coweta County, Georgia",77,13,11.89898618
425,13079,Crawford County, Georgia,43.7,12483,183,70,0,70,0,0,0,5,1,4,108,94,14,2343,40459,22183,"Crawford County, Georgia",79,13,18.76952656
426,13081,Crisp County, Georgia,38.4,23061,611,102,50,52,292,67,225,114,23,91,103,85,18,7439,31672,19943,"Crisp County, Georgia",81,13,32.25792463
427,13083,Dade County, Georgia,40.3,16356,371,25,0,25,94,41,53,74,3,71,178,158,20,2502,43463,21997,"Dade County, Georgia",83,13,15.29713866
428,13085,Dawson County, Georgia,42.8,22939,784,95,0,95,345,64,281,116,28,88,228,181,47,3028,59265,29958,"Dawson County, Georgia",85,13,13.20022669
429,13087,Decatur County, Georgia,37.8,27237,772,21,21,0,237,34,203,356,47,309,158,75,83,6885,33514,18972,"Decatur County, Georgia",87,13,25.27811433
430,13089,DeKalb County, Georgia,35.2,723902,117831,25247,1494,23753,43939,11863,32076,24776,13384,11392,23869,19225,4644,134830,52623,30517,"DeKalb County, Georgia",89,13,18.6254493
431,13091,Dodge County, Georgia,40.4,20995,397,26,0,26,92,0,92,194,25,169,85,56,29,4219,35544,18481,"Dodge County, Georgia",91,13,20.09526078
432,13093,Dooly County, Georgia,42.3,14089,562,15,0,15,102,33,69,218,39,179,227,119,108,3013,33319,16109,"Dooly County, Georgia",93,13,21.38547803
433,13095,Dougherty County, Georgia,34.6,92326,2176,364,25,339,813,334,479,373,167,206,626,400,226,26982,33605,20403,"Dougherty County, Georgia",95,13,29.22470377
434,13097,Douglas County, Georgia,36.1,138283,11589,1144,129,1015,3296,1229,2067,3675,1603,2072,3474,2784,690,20805,57384,24471,"Douglas County, Georgia",97,13,15.04523333
435,13099,Early County, Georgia,40.3,10480,157,22,10,12,48,22,26,25,18,7,62,9,53,3216,28599,17338,"Early County, Georgia",99,13,30.6870229
436,13101,Echols County, Georgia,37.1,4025,596,16,0,16,322,0,322,176,5,171,82,20,62,1214,35354,17989,"Echols County, Georgia",101,13,30.16149068
437,13103,Effingham County, Georgia,36.1,55852,1514,330,0,330,540,64,476,303,148,155,341,205,136,5985,62820,25553,"Effingham County, Georgia",103,13,10.71582038
438,13105,Elbert County, Georgia,42.1,19394,435,23,0,23,265,51,214,121,12,109,26,26,0,3768,35739,21039,"Elbert County, Georgia",105,13,19.42868929
439,13107,Emanuel County, Georgia,36.9,22723,222,18,0,18,40,0,40,117,49,68,47,32,15,6465,31522,16681,"Emanuel County, Georgia",107,13,28.45134885
440,13109,Evans County, Georgia,37.1,10733,445,4,0,4,163,24,139,189,0,189,89,49,40,2673,40594,20710,"Evans County, Georgia",109,13,24.90450014
441,13111,Fannin County, Georgia,50.3,24017,449,16,8,8,131,32,99,170,130,40,132,127,5,4262,39011,22425,"Fannin County, Georgia",111,13,17.74576342
442,13113,Fayette County, Georgia,43.5,109495,10104,1176,94,1082,2998,852,2146,2605,1626,979,3325,2588,737,7774,81689,38493,"Fayette County, Georgia",113,13,7.099867574
443,13115,Floyd County, Georgia,38.3,96199,6515,899,33,866,2032,269,1763,2102,561,1541,1482,775,707,18192,42955,22284,"Floyd County, Georgia",115,13,18.91079949
444,13117,Forsyth County, Georgia,38.1,203841,30047,3387,216,3171,13535,3985,9550,7623,4003,3620,5502,4418,1084,13024,91842,37686,"Forsyth County, Georgia",117,13,6.389293616
445,13119,Franklin County, Georgia,40.7,22188,705,185,0,185,337,51,286,73,35,38,110,83,27,5426,37298,18642,"Franklin County, Georgia",119,13,24.45466018
446,13121,Fulton County, Georgia,35,996757,124800,24206,1308,22898,43576,10598,32978,30141,16527,13614,26877,20583,6294,163674,58851,39101,"Fulton County, Georgia",121,13,16.42065218
447,13123,Gilmer County, Georgia,46.1,28956,2002,324,0,324,608,120,488,583,58,525,487,258,229,5556,43775,22893,"Gilmer County, Georgia",123,13,19.18773311
448,13125,Glascock County, Georgia,40.6,3053,20,4,0,4,6,0,6,0,0,0,10,6,4,450,43884,19037,"Glascock County, Georgia",125,13,14.73960039
449,13127,Glynn County, Georgia,40.6,82623,4532,515,47,468,1922,402,1520,701,336,365,1394,949,445,15177,46475,27819,"Glynn County, Georgia",127,13,18.36897716
450,13129,Gordon County, Georgia,37,56079,5525,549,33,516,2435,283,2152,1698,391,1307,843,635,208,11388,41390,20009,"Gordon County, Georgia",129,13,20.30706682
451,13131,Grady County, Georgia,39.8,25145,1432,166,0,166,618,5,613,510,85,425,138,106,32,7337,35518,17764,"Grady County, Georgia",131,13,29.17876317
452,13133,Greene County, Georgia,48.3,16535,818,158,29,129,422,21,401,91,25,66,147,87,60,3983,44299,31485,"Greene County, Georgia",133,13,24.08829755
453,13135,Gwinnett County, Georgia,34.8,874242,216127,19789,2041,17748,73107,19352,53755,69449,33378,36071,53782,41160,12622,112999,61865,26749,"Gwinnett County, Georgia",135,13,12.92536849
454,13137,Habersham County, Georgia,39.5,43724,3848,403,10,393,1039,81,958,1467,667,800,939,519,420,7471,41600,19171,"Habersham County, Georgia",137,13,17.08672583
455,13139,Hall County, Georgia,35.8,190482,31511,2849,205,2644,10742,1237,9505,11419,2648,8771,6501,3250,3251,33350,51902,24099,"Hall County, Georgia",139,13,17.508216
456,13141,Hancock County, Georgia,44.1,8747,233,30,0,30,100,0,100,14,0,14,89,8,81,2111,26386,13898,"Hancock County, Georgia",141,13,24.1339888
457,13143,Haralson County, Georgia,40.8,28667,398,21,0,21,49,33,16,145,94,51,183,147,36,5721,42281,21838,"Haralson County, Georgia",143,13,19.95674469
458,13145,Harris County, Georgia,42.8,32992,700,37,0,37,66,29,37,164,72,92,433,329,104,2722,65336,30703,"Harris County, Georgia",145,13,8.250484966
459,13147,Hart County, Georgia,43.1,25518,664,43,0,43,264,6,258,76,15,61,281,175,106,5228,37983,20866,"Hart County, Georgia",147,13,20.48749902
460,13149,Heard County, Georgia,41.5,11571,75,0,0,0,50,50,0,8,1,7,17,11,6,1930,44185,20494,"Heard County, Georgia",149,13,16.67963011
461,13151,Henry County, Georgia,36.5,214171,15942,1444,364,1080,4547,1843,2704,4658,2760,1898,5293,4533,760,25657,62561,25727,"Henry County, Georgia",151,13,11.97967979
462,13153,Houston County, Georgia,35,149137,8240,612,39,573,3246,853,2393,2166,1145,1021,2216,2056,160,26411,55480,25289,"Houston County, Georgia",153,13,17.70922038
463,13155,Irwin County, Georgia,38.6,9365,52,0,0,0,0,0,0,2,0,2,50,39,11,2217,29846,18514,"Irwin County, Georgia",155,13,23.67325147
464,13157,Jackson County, Georgia,38.5,62131,2904,348,27,321,647,77,570,829,252,577,1080,785,295,8330,54246,23982,"Jackson County, Georgia",157,13,13.40715585
465,13159,Jasper County, Georgia,40.9,13571,352,21,0,21,75,0,75,124,25,99,132,78,54,2685,41434,20685,"Jasper County, Georgia",159,13,19.78483531
466,13161,Jeff Davis County, Georgia,35.8,14953,779,50,0,50,447,167,280,115,16,99,167,79,88,3079,36566,17981,"Jeff Davis County, Georgia",161,13,20.59118572
467,13163,Jefferson County, Georgia,38.7,16201,325,71,0,71,128,24,104,53,41,12,73,61,12,4535,28417,16986,"Jefferson County, Georgia",163,13,27.99209925
468,13165,Jenkins County, Georgia,42.2,9055,193,0,0,0,140,21,119,0,0,0,53,39,14,2539,27398,18288,"Jenkins County, Georgia",165,13,28.03975704
469,13167,Johnson County, Georgia,39.8,9694,66,0,0,0,0,0,0,26,25,1,40,40,0,2363,32685,16693,"Johnson County, Georgia",167,13,24.37590262
470,13169,Jones County, Georgia,40.2,28701,297,0,0,0,119,26,93,41,13,28,137,134,3,3888,54020,26602,"Jones County, Georgia",169,13,13.54656632
471,13171,Lamar County, Georgia,38.4,18195,421,188,26,162,80,31,49,33,24,9,120,113,7,3746,40364,19143,"Lamar County, Georgia",171,13,20.58807365
472,13173,Lanier County, Georgia,34.2,10382,162,12,10,2,10,0,10,94,36,58,46,25,21,2827,31682,17403,"Lanier County, Georgia",173,13,27.22982084
473,13175,Laurens County, Georgia,38.4,47802,1039,110,0,110,268,98,170,370,52,318,291,247,44,12972,33632,19826,"Laurens County, Georgia",175,13,27.13693988
474,13177,Lee County, Georgia,36.8,29134,1145,175,13,162,426,227,199,276,155,121,268,228,40,3334,62797,28175,"Lee County, Georgia",177,13,11.44367406
475,13179,Liberty County, Georgia,27.4,63949,3838,307,59,248,1168,513,655,839,531,308,1524,1236,288,10443,42484,20065,"Liberty County, Georgia",179,13,16.33020063
476,13181,Lincoln County, Georgia,47.3,7712,108,8,0,8,40,31,9,24,18,6,36,22,14,1939,34720,23582,"Lincoln County, Georgia",181,13,25.14263485
477,13183,Long County, Georgia,31.7,17243,1106,147,0,147,296,19,277,484,229,255,179,95,84,2765,50848,19176,"Long County, Georgia",183,13,16.03549266
478,13185,Lowndes County, Georgia,29.9,113898,4803,973,76,897,1644,257,1387,1057,491,566,1129,905,224,27436,38915,20428,"Lowndes County, Georgia",185,13,24.08821928
479,13187,Lumpkin County, Georgia,36.8,31094,1086,99,0,99,318,0,318,396,27,369,273,202,71,6426,40634,21814,"Lumpkin County, Georgia",187,13,20.6663665
480,13189,McDuffie County, Georgia,38.1,21558,591,0,0,0,223,0,223,221,121,100,147,130,17,5537,37021,19497,"McDuffie County, Georgia",189,13,25.68420076
481,13191,McIntosh County, Georgia,48,13941,291,0,0,0,21,4,17,121,121,0,149,107,42,2788,45248,23826,"McIntosh County, Georgia",191,13,19.99856538
482,13193,Macon County, Georgia,40.1,13846,358,60,10,50,37,0,37,81,0,81,180,145,35,3897,28285,14039,"Macon County, Georgia",193,13,28.14531273
483,13195,Madison County, Georgia,40.4,28362,1088,120,0,120,162,49,113,478,129,349,328,233,95,4520,45063,21883,"Madison County, Georgia",195,13,15.93681687
484,13197,Marion County, Georgia,41.6,8646,206,33,0,33,79,0,79,38,16,22,56,47,9,2151,35484,17522,"Marion County, Georgia",197,13,24.87855656
485,13199,Meriwether County, Georgia,42.3,21195,128,5,0,5,56,5,51,35,25,10,32,21,11,4943,34989,19626,"Meriwether County, Georgia",199,13,23.3215381
486,13201,Miller County, Georgia,40.3,5911,6,0,0,0,0,0,0,0,0,0,6,0,6,1441,36463,21093,"Miller County, Georgia",201,13,24.37827779
487,13205,Mitchell County, Georgia,37.9,22778,600,185,0,185,211,3,208,87,22,65,117,68,49,6085,31111,15027,"Mitchell County, Georgia",205,13,26.71437352
488,13207,Monroe County, Georgia,42.8,27044,592,70,0,70,80,18,62,265,151,114,177,133,44,3419,50625,29053,"Monroe County, Georgia",207,13,12.6423606
489,13209,Montgomery County, Georgia,38.7,9005,488,42,20,22,133,20,113,214,80,134,99,36,63,1879,38111,19131,"Montgomery County, Georgia",209,13,20.86618545
490,13211,Morgan County, Georgia,44.1,17943,322,10,0,10,153,87,66,95,12,83,64,53,11,2354,54506,26298,"Morgan County, Georgia",211,13,13.1193223
491,13213,Murray County, Georgia,37.4,39358,2992,244,31,213,986,253,733,1392,311,1081,370,265,105,7315,38136,17856,"Murray County, Georgia",213,13,18.58580212
492,13215,Muscogee County, Georgia,33.6,200303,11031,1952,50,1902,2717,711,2006,2323,1244,1079,4039,3400,639,40006,42661,23747,"Muscogee County, Georgia",215,13,19.9727413
493,13217,Newton County, Georgia,36.1,103901,6282,521,24,497,2035,445,1590,1521,914,607,2205,1763,442,17415,51068,22478,"Newton County, Georgia",217,13,16.76114763
494,13219,Oconee County, Georgia,39.8,35071,2218,115,0,115,659,145,514,801,320,481,643,479,164,2485,75946,37054,"Oconee County, Georgia",219,13,7.085626301
495,13221,Oglethorpe County, Georgia,42.3,14743,343,32,3,29,145,2,143,102,28,74,64,34,30,2612,44403,20987,"Oglethorpe County, Georgia",221,13,17.71688259
496,13223,Paulding County, Georgia,35.4,149830,7752,582,113,469,2244,1062,1182,2341,1078,1263,2585,2135,450,15974,60971,25655,"Paulding County, Georgia",223,13,10.66141627
497,13225,Peach County, Georgia,34.9,26907,1438,170,27,143,608,111,497,405,126,279,255,225,30,5206,41128,20746,"Peach County, Georgia",225,13,19.34812502
498,13227,Pickens County, Georgia,44.8,29992,896,22,0,22,211,49,162,262,77,185,401,373,28,3058,56769,28637,"Pickens County, Georgia",227,13,10.19605228
499,13229,Pierce County, Georgia,38.9,19030,466,6,0,6,196,60,136,87,0,87,177,99,78,3764,42730,23470,"Pierce County, Georgia",229,13,19.77929585
500,13231,Pike County, Georgia,39.4,17843,162,0,0,0,55,0,55,53,24,29,54,32,22,2120,50819,23783,"Pike County, Georgia",231,13,11.88141008
501,13233,Polk County, Georgia,37.4,41263,2910,116,26,90,1311,173,1138,711,211,500,772,475,297,8229,39356,21582,"Polk County, Georgia",233,13,19.9428059
502,13235,Pulaski County, Georgia,41.4,11460,170,0,0,0,36,0,36,76,63,13,58,13,45,2342,38880,17587,"Pulaski County, Georgia",235,13,20.43630017
503,13237,Putnam County, Georgia,45.3,21259,1215,130,19,111,451,60,391,343,175,168,291,198,93,3727,45762,25164,"Putnam County, Georgia",237,13,17.53139847
504,13239,Quitman County, Georgia,48.1,2095,34,0,0,0,5,5,0,0,0,0,29,18,11,538,29773,18499,"Quitman County, Georgia",239,13,25.68019093
505,13241,Rabun County, Georgia,48.4,16312,938,41,7,34,285,45,240,473,153,320,139,85,54,3491,38277,24374,"Rabun County, Georgia",241,13,21.40142227
506,13243,Randolph County, Georgia,41.4,7224,173,0,0,0,0,0,0,134,132,2,39,39,0,2018,30358,26198,"Randolph County, Georgia",243,13,27.93466224
507,13245,Richmond County, Georgia,33.5,201418,7048,971,107,864,1540,406,1134,1389,691,698,3148,2328,820,48495,38595,20956,"Richmond County, Georgia",245,13,24.07679552
508,13247,Rockdale County, Georgia,37.5,87569,8413,430,117,313,2863,717,2146,2138,1321,817,2982,2380,602,14863,51072,23003,"Rockdale County, Georgia",247,13,16.97290137
509,13249,Schley County, Georgia,38.3,5089,82,28,7,21,6,6,0,42,0,42,6,6,0,1113,41227,21202,"Schley County, Georgia",249,13,21.87070151
510,13251,Screven County, Georgia,40.5,14114,143,32,23,9,48,3,45,19,19,0,44,39,5,3425,35047,19801,"Screven County, Georgia",251,13,24.26668556
511,13253,Seminole County, Georgia,45.2,8696,120,0,0,0,66,22,44,35,0,35,19,13,6,1639,35410,21484,"Seminole County, Georgia",253,13,18.84774609
512,13255,Spalding County, Georgia,38.5,64006,2207,201,0,201,926,325,601,507,189,318,573,458,115,14798,40548,19899,"Spalding County, Georgia",255,13,23.11970753
513,13257,Stephens County, Georgia,41.2,25584,538,20,0,20,368,18,350,67,36,31,83,47,36,4995,37088,20125,"Stephens County, Georgia",257,13,19.5239212
514,13259,Stewart County, Georgia,37.3,5791,1687,628,0,628,482,0,482,412,8,404,165,12,153,1666,20882,13883,"Stewart County, Georgia",259,13,28.76877914
515,13261,Sumter County, Georgia,35,31070,974,108,9,99,367,105,262,190,50,140,309,150,159,9749,33534,18487,"Sumter County, Georgia",261,13,31.3775346
516,13263,Talbot County, Georgia,47.9,6373,62,0,0,0,0,0,0,18,9,9,44,20,24,1307,36957,20366,"Talbot County, Georgia",263,13,20.50839479
517,13265,Taliaferro County, Georgia,44,1904,65,8,0,8,23,23,0,16,16,0,18,5,13,593,28152,15469,"Taliaferro County, Georgia",265,13,31.14495798
518,13267,Tattnall County, Georgia,36.6,25260,905,76,0,76,266,15,251,447,83,364,116,65,51,5290,35578,15632,"Tattnall County, Georgia",267,13,20.94220111
519,13269,Taylor County, Georgia,42.7,8354,102,3,0,3,54,0,54,10,10,0,35,26,9,2310,27114,17321,"Taylor County, Georgia",269,13,27.65142447
520,13271,Telfair County, Georgia,39.6,16405,2068,234,0,234,728,19,709,613,72,541,493,43,450,3611,27657,12440,"Telfair County, Georgia",271,13,22.01158183
521,13273,Terrell County, Georgia,41.2,9132,54,0,0,0,10,0,10,10,10,0,34,19,15,3053,30438,17246,"Terrell County, Georgia",273,13,33.43188787
522,13275,Thomas County, Georgia,39.6,44977,1257,228,0,228,515,17,498,273,198,75,241,182,59,9377,38241,22178,"Thomas County, Georgia",275,13,20.84843364
523,13277,Tift County, Georgia,35.2,40691,2612,187,31,156,882,235,647,1045,472,573,498,259,239,10638,37613,20642,"Tift County, Georgia",277,13,26.14337323
524,13279,Toombs County, Georgia,35.6,27160,1673,104,0,104,645,65,580,672,188,484,252,81,171,7117,33081,20309,"Toombs County, Georgia",279,13,26.20397644
525,13281,Towns County, Georgia,53,10976,303,41,0,41,67,32,35,23,12,11,172,125,47,1528,39321,21671,"Towns County, Georgia",281,13,13.9212828
526,13283,Treutlen County, Georgia,40.3,6711,83,24,0,24,51,14,37,0,0,0,8,8,0,1184,40204,21307,"Treutlen County, Georgia",283,13,17.6426762
527,13285,Troup County, Georgia,36.2,69314,2799,492,0,492,1041,191,850,682,275,407,584,492,92,14388,42545,21942,"Troup County, Georgia",285,13,20.75771128
528,13287,Turner County, Georgia,39.2,8151,351,4,0,4,175,15,160,145,14,131,27,0,27,2157,34667,17149,"Turner County, Georgia",287,13,26.46301067
529,13289,Twiggs County, Georgia,45.7,8363,90,89,0,89,1,0,1,0,0,0,0,0,0,2504,31625,18255,"Twiggs County, Georgia",289,13,29.94140859
530,13291,Union County, Georgia,53.6,22033,473,14,0,14,138,5,133,158,30,128,163,149,14,2822,41686,23603,"Union County, Georgia",291,13,12.80806064
531,13293,Upson County, Georgia,41.1,26394,354,15,15,0,198,70,128,70,0,70,71,46,25,5910,35699,19511,"Upson County, Georgia",293,13,22.3914526
532,13295,Walker County, Georgia,40.7,68143,787,236,25,211,208,32,176,127,78,49,216,70,146,12273,41539,21588,"Walker County, Georgia",295,13,18.01065407
533,13297,Walton County, Georgia,38.9,87436,3379,529,105,424,769,355,414,736,394,342,1345,1106,239,11365,54459,24141,"Walton County, Georgia",297,13,12.99807859
534,13299,Ware County, Georgia,38.2,35671,1208,38,0,38,504,47,457,384,164,220,282,224,58,9310,34705,18396,"Ware County, Georgia",299,13,26.09963275
535,13301,Warren County, Georgia,45,5504,109,7,0,7,70,18,52,0,0,0,32,32,0,1432,31875,18381,"Warren County, Georgia",301,13,26.01744186
536,13303,Washington County, Georgia,40.3,20680,346,24,3,21,163,5,158,67,11,56,92,57,35,4996,37417,18662,"Washington County, Georgia",303,13,24.15860735
537,13305,Wayne County, Georgia,37.9,30006,846,164,8,156,321,119,202,158,14,144,203,117,86,5684,39908,18663,"Wayne County, Georgia",305,13,18.94287809
538,13307,Webster County, Georgia,39.8,2672,7,0,0,0,0,0,0,7,0,7,0,0,0,596,37072,20834,"Webster County, Georgia",307,13,22.30538922
539,13309,Wheeler County, Georgia,38.4,7932,121,1,1,0,33,1,32,68,18,50,19,0,19,1383,27779,9688,"Wheeler County, Georgia",309,13,17.43570348
540,13311,White County, Georgia,44.5,28140,775,70,0,70,128,29,99,77,14,63,500,429,71,5345,42264,22055,"White County, Georgia",311,13,18.99431414
541,13313,Whitfield County, Georgia,35.1,103653,18977,1168,93,1075,6327,1146,5181,6890,1527,5363,4592,2068,2524,20126,41764,21158,"Whitfield County, Georgia",313,13,19.41670767
542,13315,Wilcox County, Georgia,39.3,8884,212,0,0,0,93,3,90,89,11,78,30,16,14,1422,34071,14536,"Wilcox County, Georgia",315,13,16.00630347
543,13317,Wilkes County, Georgia,44.7,9924,354,135,0,135,147,13,134,42,42,0,30,24,6,2620,33462,19129,"Wilkes County, Georgia",317,13,26.4006449
544,13319,Wilkinson County, Georgia,42.8,9312,72,2,0,2,3,0,3,26,0,26,41,26,15,1915,38827,19173,"Wilkinson County, Georgia",319,13,20.56486254
545,13321,Worth County, Georgia,41,20988,347,11,0,11,0,0,0,150,21,129,186,140,46,3837,38684,20068,"Worth County, Georgia",321,13,18.28187536
546,15001,Hawaii County, Hawaii,41.8,193680,21312,2238,172,2066,6171,1520,4651,4497,2365,2132,8406,6856,1550,35737,53936,25827,"Hawaii County, Hawaii",1,15,18.4515696
547,15003,Honolulu County, Hawaii,37.4,986999,190161,24361,2311,22050,47301,16527,30774,39047,24513,14534,79452,66581,12871,90359,77161,32194,"Honolulu County, Hawaii",3,15,9.154923156
548,15005,Kalawao County, Hawaii,56.5,91,11,1,0,1,0,0,0,0,0,0,10,10,0,11,65625,45812,"Kalawao County, Hawaii",5,15,12.08791209
549,15007,Kauai County, Hawaii,42,70447,11270,1470,154,1316,2562,638,1924,2678,1471,1207,4560,3798,762,6703,68224,28791,"Kauai County, Hawaii",7,15,9.514954505
550,15009,Maui County, Hawaii,40.5,162456,30797,3859,392,3467,8444,2861,5583,6450,4037,2413,12044,9624,2420,15767,68777,30599,"Maui County, Hawaii",9,15,9.705397154
551,16001,Ada County, Idaho,36.1,425798,25827,4580,296,4284,8214,2787,5427,6918,4141,2777,6115,4519,1596,51101,58099,30086,"Ada County, Idaho",1,16,12.00123063
552,16003,Adams County, Idaho,51.7,3865,66,8,0,8,18,15,3,6,6,0,34,26,8,561,41335,22741,"Adams County, Idaho",3,16,14.5148771
553,16005,Bannock County, Idaho,33,83815,3335,1211,47,1164,692,237,455,530,224,306,902,697,205,14875,45216,22885,"Bannock County, Idaho",5,16,17.74741991
554,16007,Bear Lake County, Idaho,39.5,5928,152,10,0,10,28,25,3,31,24,7,83,82,1,847,46863,22985,"Bear Lake County, Idaho",7,16,14.28812416
555,16009,Benewah County, Idaho,46,9068,149,7,0,7,76,24,52,24,20,4,42,19,23,1510,42600,22055,"Benewah County, Idaho",9,16,16.65196295
556,16011,Bingham County, Idaho,33,45261,3181,188,4,184,601,57,544,879,244,635,1513,817,696,6008,49943,20199,"Bingham County, Idaho",11,16,13.27412121
557,16013,Blaine County, Idaho,42.9,21427,3031,602,162,440,828,278,550,771,199,572,830,445,385,2707,58086,34330,"Blaine County, Idaho",13,16,12.63359313
558,16015,Boise County, Idaho,53.1,6891,161,21,0,21,18,6,12,31,15,16,91,82,9,938,44591,28273,"Boise County, Idaho",15,16,13.61195763
559,16017,Bonner County, Idaho,47.5,41389,981,42,0,42,189,35,154,114,64,50,636,487,149,6092,43697,24507,"Bonner County, Idaho",17,16,14.71888666
560,16019,Bonneville County, Idaho,32.6,108989,6097,665,124,541,1568,392,1176,1756,585,1171,2108,1557,551,13711,52831,24889,"Bonneville County, Idaho",19,16,12.58016864
561,16021,Boundary County, Idaho,43.4,11141,288,46,0,46,40,16,24,21,19,2,181,76,105,1813,39279,22822,"Boundary County, Idaho",21,16,16.27322502
562,16023,Butte County, Idaho,45,2592,48,4,0,4,18,0,18,7,7,0,19,14,5,396,39653,25209,"Butte County, Idaho",23,16,15.27777778
563,16025,Camas County, Idaho,40.3,968,42,0,0,0,18,0,18,15,0,15,9,2,7,192,42708,26544,"Camas County, Idaho",25,16,19.83471074
564,16027,Canyon County, Idaho,33,202782,15694,963,98,865,3941,645,3296,4460,1282,3178,6330,3104,3226,37366,44860,18639,"Canyon County, Idaho",27,16,18.42668481
565,16029,Caribou County, Idaho,36.8,6813,168,67,0,67,18,0,18,25,5,20,58,40,18,680,57957,25146,"Caribou County, Idaho",29,16,9.980918832
566,16031,Cassia County, Idaho,31.8,23441,2641,113,3,110,616,24,592,929,154,775,983,534,449,3563,46215,18785,"Cassia County, Idaho",31,16,15.19986349
567,16033,Clark County, Idaho,30.3,960,263,13,0,13,129,0,129,72,17,55,49,6,43,260,32422,14622,"Clark County, Idaho",33,16,27.08333333
568,16035,Clearwater County, Idaho,50.3,8528,170,6,0,6,44,20,24,43,24,19,77,57,20,972,40266,21316,"Clearwater County, Idaho",35,16,11.39774859
569,16037,Custer County, Idaho,52.1,4185,71,5,0,5,19,11,8,13,6,7,34,34,0,852,39497,23624,"Custer County, Idaho",37,16,20.35842294
570,16039,Elmore County, Idaho,31.1,26103,2539,465,81,384,383,174,209,773,270,503,918,692,226,4587,44444,22045,"Elmore County, Idaho",39,16,17.57269279
571,16041,Franklin County, Idaho,32.8,13013,442,14,0,14,206,12,194,79,1,78,143,99,44,1606,50500,19985,"Franklin County, Idaho",41,16,12.34150465
572,16043,Fremont County, Idaho,36.9,12896,596,43,0,43,151,25,126,248,15,233,154,63,91,1475,49973,21196,"Fremont County, Idaho",43,16,11.43765509
573,16045,Gem County, Idaho,45.4,16853,531,44,0,44,185,0,185,160,15,145,142,74,68,3705,40767,18745,"Gem County, Idaho",45,16,21.98421646
574,16047,Gooding County, Idaho,36.7,15157,2286,122,35,87,882,167,715,607,70,537,675,338,337,2348,40704,20418,"Gooding County, Idaho",47,16,15.49119219
575,16049,Idaho County, Idaho,49.3,16251,267,19,4,15,0,0,0,80,17,63,168,147,21,2536,38597,19524,"Idaho County, Idaho",49,16,15.60519353
576,16051,Jefferson County, Idaho,31.4,27096,1120,119,0,119,311,51,260,236,65,171,454,192,262,3023,54646,20750,"Jefferson County, Idaho",51,16,11.15662828
577,16053,Jerome County, Idaho,32.4,22694,3836,507,7,500,1446,273,1173,1092,245,847,791,265,526,3786,44447,18214,"Jerome County, Idaho",53,16,16.68282365
578,16055,Kootenai County, Idaho,39.7,147716,3233,263,11,252,506,323,183,543,296,247,1921,1493,428,18412,50924,26514,"Kootenai County, Idaho",55,16,12.46445883
579,16057,Latah County, Idaho,28.3,38593,2011,917,0,917,439,178,261,345,146,199,310,181,129,7929,42133,22717,"Latah County, Idaho",57,16,20.54517659
580,16059,Lemhi County, Idaho,52.6,7743,140,0,0,0,73,38,35,0,0,0,67,41,26,1284,34762,21953,"Lemhi County, Idaho",59,16,16.58271988
581,16061,Lewis County, Idaho,47.9,3826,77,27,0,27,8,6,2,2,1,1,40,18,22,598,38068,22589,"Lewis County, Idaho",61,16,15.62990068
582,16063,Lincoln County, Idaho,33.8,5292,721,124,0,124,213,37,176,249,64,185,135,62,73,630,44500,18239,"Lincoln County, Idaho",63,16,11.9047619
583,16065,Madison County, Idaho,23.3,38114,1740,488,7,481,610,76,534,402,277,125,240,163,77,12226,33856,15103,"Madison County, Idaho",65,16,32.07745185
584,16067,Minidoka County, Idaho,35.4,20331,3264,351,0,351,973,294,679,1021,221,800,919,447,472,3584,46147,22103,"Minidoka County, Idaho",67,16,17.62825242
585,16069,Nez Perce County, Idaho,41.2,39995,593,156,25,131,151,92,59,63,45,18,223,156,67,5266,49541,25179,"Nez Perce County, Idaho",69,16,13.16664583
586,16071,Oneida County, Idaho,38.9,4269,101,2,0,2,61,0,61,4,0,4,34,26,8,582,40564,19073,"Oneida County, Idaho",71,16,13.63316936
587,16073,Owyhee County, Idaho,37.7,11356,1145,73,15,58,325,11,314,377,30,347,370,155,215,2643,34785,18135,"Owyhee County, Idaho",73,16,23.27404015
588,16075,Payette County, Idaho,39.1,22773,1387,5,0,5,423,86,337,401,84,317,558,268,290,4199,45670,21700,"Payette County, Idaho",75,16,18.43850173
589,16077,Power County, Idaho,34.7,7696,918,156,0,156,276,6,270,185,93,92,301,143,158,937,46318,20431,"Power County, Idaho",77,16,12.17515593
590,16079,Shoshone County, Idaho,47.2,12551,243,47,0,47,59,17,42,52,36,16,85,55,30,2208,37449,21875,"Shoshone County, Idaho",79,16,17.59222373
591,16081,Teton County, Idaho,35.6,10437,1003,105,0,105,372,5,367,420,52,368,106,73,33,1283,58173,29251,"Teton County, Idaho",81,16,12.29280445
592,16083,Twin Falls County, Idaho,34.6,80955,6518,818,68,750,2359,452,1907,1803,689,1114,1538,846,692,12417,45500,21682,"Twin Falls County, Idaho",83,16,15.33815082
593,16085,Valley County, Idaho,48.8,9897,52,5,0,5,26,0,26,0,0,0,21,21,0,1369,53630,28133,"Valley County, Idaho",85,16,13.83247449
594,16087,Washington County, Idaho,44.6,10035,608,0,0,0,235,7,228,47,5,42,326,172,154,1508,37525,19559,"Washington County, Idaho",87,16,15.02740409
595,17001,Adams County, Illinois,41.1,66949,995,218,51,167,249,144,105,71,49,22,457,327,130,8457,48065,26053,"Adams County, Illinois",1,17,12.63200347
596,17003,Alexander County, Illinois,41.9,7051,52,5,0,5,13,1,12,14,3,11,20,17,3,2284,29071,16067,"Alexander County, Illinois",3,17,32.39256843
597,17005,Bond County, Illinois,41.3,17137,422,44,0,44,188,37,151,87,50,37,103,61,42,2553,52159,23660,"Bond County, Illinois",5,17,14.89759001
598,17007,Boone County, Illinois,38.3,53656,6219,452,93,359,1379,475,904,2005,552,1453,2383,1786,597,5908,60063,27825,"Boone County, Illinois",7,17,11.01088415
599,17009,Brown County, Illinois,37.4,6836,130,7,0,7,58,12,46,34,9,25,31,15,16,591,52500,21822,"Brown County, Illinois",9,17,8.645406671
600,17011,Bureau County, Illinois,43.6,33822,1275,112,9,103,183,29,154,436,105,331,544,278,266,4340,51425,27332,"Bureau County, Illinois",11,17,12.83188457
601,17013,Calhoun County, Illinois,46.7,4962,45,2,0,2,11,1,10,5,0,5,27,27,0,595,52949,25341,"Calhoun County, Illinois",13,17,11.99113261
602,17015,Carroll County, Illinois,47.7,14793,442,16,0,16,90,46,44,169,47,122,167,147,20,1663,50052,27325,"Carroll County, Illinois",15,17,11.24180356
603,17017,Cass County, Illinois,40.1,13068,1392,160,0,160,651,83,568,343,129,214,238,151,87,1787,48887,25010,"Cass County, Illinois",17,17,13.67462504
604,17019,Champaign County, Illinois,29.5,206420,23787,9085,308,8777,7015,1951,5064,4391,3019,1372,3296,2590,706,41161,48899,27373,"Champaign County, Illinois",19,17,19.94041275
605,17021,Christian County, Illinois,42.5,33888,324,18,0,18,58,33,25,129,119,10,119,92,27,4356,47417,23823,"Christian County, Illinois",21,17,12.85410765
606,17023,Clark County, Illinois,43.1,16089,182,11,0,11,69,12,57,48,12,36,54,47,7,2576,48693,25806,"Clark County, Illinois",23,17,16.01093915
607,17025,Clay County, Illinois,43.1,13466,158,5,0,5,68,5,63,6,0,6,79,76,3,1854,45984,23843,"Clay County, Illinois",25,17,13.76800832
608,17027,Clinton County, Illinois,40.1,37858,652,72,1,71,290,219,71,133,60,73,157,131,26,3406,63929,29512,"Clinton County, Illinois",27,17,8.996777431
609,17029,Coles County, Illinois,33.6,52802,1232,506,0,506,256,80,176,135,107,28,335,262,73,10711,38800,23944,"Coles County, Illinois",29,17,20.28521647
610,17031,Cook County, Illinois,36.1,5227575,1101730,114142,8317,105825,291815,85846,205969,309401,151109,158292,386372,288838,97534,856682,56902,32179,"Cook County, Illinois",31,17,16.38775149
611,17033,Crawford County, Illinois,42.5,19441,306,2,0,2,140,38,102,50,9,41,114,54,60,2192,47364,26245,"Crawford County, Illinois",33,17,11.27514017
612,17035,Cumberland County, Illinois,41.6,10890,85,15,0,15,22,22,0,16,5,11,32,19,13,1747,44281,22786,"Cumberland County, Illinois",35,17,16.04224059
613,17037,DeKalb County, Illinois,30.5,104458,6884,1084,16,1068,2170,609,1561,1661,764,897,1969,1357,612,18001,56076,25172,"DeKalb County, Illinois",37,17,17.23276341
614,17039,De Witt County, Illinois,43.3,16322,223,17,0,17,42,14,28,65,26,39,99,42,57,1926,53510,28294,"De Witt County, Illinois",39,17,11.80002451
615,17041,Douglas County, Illinois,38,19770,748,4,0,4,317,81,236,215,130,85,212,102,110,2223,52984,26309,"Douglas County, Illinois",41,17,11.24430956
616,17043,DuPage County, Illinois,38.9,930514,175061,18036,1625,16411,48283,16941,31342,48072,28700,19372,60670,51278,9392,64677,81521,40547,"DuPage County, Illinois",43,17,6.950674573
617,17045,Edgar County, Illinois,44.1,17828,154,42,0,42,32,11,21,20,5,15,60,51,9,2845,46440,25122,"Edgar County, Illinois",45,17,15.95804353
618,17047,Edwards County, Illinois,43.6,6612,61,0,0,0,16,8,8,28,22,6,17,17,0,760,47035,25235,"Edwards County, Illinois",47,17,11.49425287
619,17049,Effingham County, Illinois,39.2,34356,521,147,0,147,142,29,113,144,123,21,88,61,27,3634,52977,27680,"Effingham County, Illinois",49,17,10.57748283
620,17051,Fayette County, Illinois,40.4,22025,186,42,0,42,59,12,47,3,3,0,82,57,25,3240,44745,21665,"Fayette County, Illinois",51,17,14.71055619
621,17053,Ford County, Illinois,43.4,13758,159,6,0,6,4,0,4,21,9,12,128,72,56,1871,49257,25524,"Ford County, Illinois",53,17,13.59936037
622,17055,Franklin County, Illinois,41.9,39503,369,45,0,45,58,16,42,82,21,61,184,151,33,7440,39507,22119,"Franklin County, Illinois",55,17,18.83401261
623,17057,Fulton County, Illinois,42.4,36047,765,141,0,141,257,5,252,145,8,137,222,184,38,5232,46183,22969,"Fulton County, Illinois",57,17,14.514384
624,17059,Gallatin County, Illinois,44.7,5325,30,0,0,0,0,0,0,0,0,0,30,30,0,860,41269,23109,"Gallatin County, Illinois",59,17,16.15023474
625,17061,Greene County, Illinois,42.5,13390,75,12,0,12,13,8,5,15,15,0,35,25,10,2250,42880,21916,"Greene County, Illinois",61,17,16.80358476
626,17063,Grundy County, Illinois,37.2,50338,1951,92,33,59,399,188,211,572,336,236,888,807,81,4899,67162,30232,"Grundy County, Illinois",63,17,9.732210259
627,17065,Hamilton County, Illinois,43,8251,20,6,0,6,9,7,2,0,0,0,5,5,0,1219,45076,24309,"Hamilton County, Illinois",65,17,14.77396679
628,17067,Hancock County, Illinois,46.4,18633,197,27,0,27,32,15,17,63,42,21,75,61,14,2124,50077,25647,"Hancock County, Illinois",67,17,11.39913057
629,17069,Hardin County, Illinois,46.1,4173,30,0,0,0,0,0,0,0,0,0,30,30,0,774,39926,21573,"Hardin County, Illinois",69,17,18.54780733
630,17071,Henderson County, Illinois,49.2,6966,80,11,0,11,52,13,39,1,0,1,16,16,0,731,46216,26504,"Henderson County, Illinois",71,17,10.49382716
631,17073,Henry County, Illinois,42.3,49681,1356,40,21,19,425,54,371,339,164,175,552,344,208,6019,54757,27777,"Henry County, Illinois",73,17,12.11529559
632,17075,Iroquois County, Illinois,44.3,28814,912,40,23,17,342,62,280,158,20,138,372,221,151,4556,47823,25562,"Iroquois County, Illinois",75,17,15.81175817
633,17077,Jackson County, Illinois,30.8,59188,3533,1070,21,1049,1292,273,1019,480,233,247,691,445,246,15533,33845,21948,"Jackson County, Illinois",77,17,26.2434953
634,17079,Jasper County, Illinois,42.8,9592,89,59,0,59,1,1,0,0,0,0,29,22,7,775,56305,25811,"Jasper County, Illinois",79,17,8.079649708
635,17081,Jefferson County, Illinois,40.9,38523,660,153,0,153,149,95,54,184,148,36,174,152,22,6392,43467,23054,"Jefferson County, Illinois",81,17,16.59268489
636,17083,Jersey County, Illinois,42.4,22441,284,57,0,57,135,60,75,9,7,2,83,79,4,1954,52738,26346,"Jersey County, Illinois",83,17,8.707276859
637,17085,Jo Daviess County, Illinois,48.6,22186,651,43,0,43,94,31,63,241,112,129,273,227,46,2051,54702,29892,"Jo Daviess County, Illinois",85,17,9.244568647
638,17087,Johnson County, Illinois,42.9,12866,160,1,0,1,25,12,13,62,16,46,72,39,33,1363,44179,20928,"Johnson County, Illinois",87,17,10.59381315
639,17089,Kane County, Illinois,36.2,526615,96268,6345,571,5774,28648,5442,23206,30010,9551,20459,31265,21153,10112,57312,71602,31774,"Kane County, Illinois",89,17,10.88309296
640,17091,Kankakee County, Illinois,37.4,111493,5781,599,87,512,1672,339,1333,1934,676,1258,1576,1101,475,16800,54697,25111,"Kankakee County, Illinois",91,17,15.06821056
641,17093,Kendall County, Illinois,34.4,121452,10887,803,343,460,3534,1462,2072,2767,1274,1493,3783,2993,790,6578,85736,31920,"Kendall County, Illinois",93,17,5.416131476
642,17095,Knox County, Illinois,42.1,51752,1469,469,0,469,451,143,308,209,153,56,340,237,103,8418,40605,22939,"Knox County, Illinois",95,17,16.26603803
643,17097,Lake County, Illinois,37.8,702890,129408,11365,711,10654,31710,8334,23376,43372,21238,22134,42961,32620,10341,60664,79886,40655,"Lake County, Illinois",97,17,8.630653445
644,17099,LaSalle County, Illinois,41.8,111935,3708,271,16,255,802,222,580,1011,378,633,1624,1123,501,15069,51684,26228,"LaSalle County, Illinois",99,17,13.46227721
645,17101,Lawrence County, Illinois,39.6,16582,441,28,0,28,116,19,97,132,10,122,165,63,102,1929,42650,16417,"Lawrence County, Illinois",101,17,11.63309613
646,17103,Lee County, Illinois,42.7,34718,943,44,0,44,337,113,224,172,70,102,390,231,159,3783,55067,27021,"Lee County, Illinois",103,17,10.896365
647,17105,Livingston County, Illinois,41.2,37278,669,89,3,86,189,44,145,145,45,100,246,157,89,4364,54074,26777,"Livingston County, Illinois",105,17,11.70663662
648,17107,Logan County, Illinois,40,29820,511,62,17,45,136,9,127,144,66,78,169,103,66,2996,52676,23410,"Logan County, Illinois",107,17,10.04694836
649,17109,McDonough County, Illinois,30.7,31727,1263,428,15,413,263,76,187,262,147,115,310,170,140,6513,41484,22387,"McDonough County, Illinois",109,17,20.52825669
650,17111,McHenry County, Illinois,39.6,307083,28414,1750,188,1562,7876,1986,5890,8817,4627,4190,9971,7688,2283,23653,79836,34589,"McHenry County, Illinois",111,17,7.702477832
651,17113,McLean County, Illinois,32.6,173254,11610,3655,63,3592,4390,1276,3114,1930,1047,883,1635,1430,205,23485,63420,31752,"McLean County, Illinois",113,17,13.55524259
652,17115,Macon County, Illinois,40.7,108404,2461,267,22,245,1013,218,795,638,461,177,543,410,133,19626,47477,27010,"Macon County, Illinois",115,17,18.10449799
653,17117,Macoupin County, Illinois,43,46482,288,25,4,21,55,24,31,105,81,24,103,77,26,5875,52337,26779,"Macoupin County, Illinois",117,17,12.63930123
654,17119,Madison County, Illinois,39.7,266759,6102,717,49,668,1877,680,1197,1255,496,759,2253,1809,444,34400,54573,29100,"Madison County, Illinois",119,17,12.89553492
655,17121,Marion County, Illinois,41.6,38503,518,168,0,168,109,59,50,29,0,29,212,173,39,6867,43427,23366,"Marion County, Illinois",121,17,17.8349739
656,17123,Marshall County, Illinois,46.4,12060,198,10,0,10,49,21,28,27,9,18,112,87,25,1163,54189,28279,"Marshall County, Illinois",123,17,9.64344942
657,17125,Mason County, Illinois,45.1,13931,142,0,0,0,21,12,9,19,15,4,102,67,35,2115,43125,25166,"Mason County, Illinois",125,17,15.18196827
658,17127,Massac County, Illinois,44,14883,150,19,0,19,24,24,0,31,31,0,76,56,20,2750,42706,23673,"Massac County, Illinois",127,17,18.4774575
659,17129,Menard County, Illinois,42.6,12576,87,0,0,0,0,0,0,33,18,15,54,51,3,1564,60420,31323,"Menard County, Illinois",129,17,12.43638677
660,17131,Mercer County, Illinois,44.8,15971,200,34,15,19,13,6,7,8,1,7,145,139,6,1618,55750,27566,"Mercer County, Illinois",131,17,10.13086219
661,17133,Monroe County, Illinois,42.3,33703,518,7,0,7,218,156,62,65,65,0,228,191,37,1480,72956,35699,"Monroe County, Illinois",133,17,4.391300478
662,17135,Montgomery County, Illinois,42.4,29301,293,8,0,8,31,20,11,90,85,5,164,67,97,3725,45173,21072,"Montgomery County, Illinois",135,17,12.71287669
663,17137,Morgan County, Illinois,41.1,34801,723,222,0,222,219,114,105,125,84,41,157,120,37,4684,47760,25201,"Morgan County, Illinois",137,17,13.45938335
664,17139,Moultrie County, Illinois,40.7,14915,141,24,0,24,27,4,23,42,8,34,48,48,0,1769,51432,25351,"Moultrie County, Illinois",139,17,11.86054308
665,17141,Ogle County, Illinois,41.8,52034,2879,312,12,300,892,274,618,953,458,495,722,511,211,5617,55832,28026,"Ogle County, Illinois",141,17,10.7948649
666,17143,Peoria County, Illinois,36.9,186818,10120,1727,5,1722,3779,1047,2732,1953,985,968,2661,2254,407,29991,51632,29055,"Peoria County, Illinois",143,17,16.05359227
667,17145,Perry County, Illinois,41.6,21595,248,14,9,5,41,8,33,62,17,45,131,95,36,3102,43308,22650,"Perry County, Illinois",145,17,14.36443621
668,17147,Piatt County, Illinois,43.3,16469,179,33,0,33,88,18,70,10,0,10,48,42,6,927,69160,33197,"Piatt County, Illinois",147,17,5.628757059
669,17149,Pike County, Illinois,42.5,16054,104,0,0,0,39,29,10,11,11,0,54,26,28,2233,40157,22048,"Pike County, Illinois",149,17,13.90930609
670,17151,Pope County, Illinois,50.6,4255,43,4,0,4,7,7,0,10,10,0,22,22,0,604,39243,21427,"Pope County, Illinois",151,17,14.19506463
671,17153,Pulaski County, Illinois,43.5,5792,71,17,0,17,36,15,21,5,0,5,13,10,3,1051,32538,18924,"Pulaski County, Illinois",153,17,18.14571823
672,17155,Putnam County, Illinois,46.4,5746,148,9,0,9,60,6,54,6,6,0,73,45,28,595,64085,32584,"Putnam County, Illinois",155,17,10.35502959
673,17157,Randolph County, Illinois,41.4,32934,423,34,0,34,74,44,30,170,90,80,145,95,50,3219,48343,23424,"Randolph County, Illinois",157,17,9.774093642
674,17159,Richland County, Illinois,42.1,16072,217,45,0,45,88,53,35,15,2,13,69,61,8,2311,45597,23972,"Richland County, Illinois",159,17,14.3790443
675,17161,Rock Island County, Illinois,40.1,146536,11625,2400,68,2332,4129,1398,2731,2288,848,1440,2808,2025,783,21375,50208,26893,"Rock Island County, Illinois",161,17,14.5868592
676,17163,St. Clair County, Illinois,37.8,265569,7028,983,60,923,1685,630,1055,1580,966,614,2780,2304,476,46059,50006,27683,"St. Clair County, Illinois",163,17,17.34351524
677,17165,Saline County, Illinois,42,24659,315,10,0,10,137,57,80,75,28,47,93,93,0,5334,40290,21917,"Saline County, Illinois",165,17,21.63104749
678,17167,Sangamon County, Illinois,39.9,198639,6065,1304,98,1206,1837,783,1054,1171,805,366,1753,1392,361,29600,56742,31904,"Sangamon County, Illinois",167,17,14.90140405
679,17169,Schuyler County, Illinois,45.5,7205,68,35,0,35,13,12,1,9,0,9,11,1,10,1411,48396,24323,"Schuyler County, Illinois",169,17,19.58362248
680,17171,Scott County, Illinois,43.3,5169,26,7,0,7,3,3,0,3,1,2,13,6,7,747,46210,25568,"Scott County, Illinois",171,17,14.45153802
681,17173,Shelby County, Illinois,44.4,22011,92,17,2,15,31,10,21,13,13,0,31,2,29,2810,48572,23974,"Shelby County, Illinois",173,17,12.7663441
682,17175,Stark County, Illinois,46.2,5840,34,0,0,0,0,0,0,6,6,0,28,12,16,768,52058,28545,"Stark County, Illinois",175,17,13.15068493
683,17177,Stephenson County, Illinois,44.6,46283,937,166,20,146,342,197,145,131,74,57,298,209,89,7203,45624,24529,"Stephenson County, Illinois",177,17,15.56294968
684,17179,Tazewell County, Illinois,40.6,135400,2496,307,34,273,551,183,368,584,315,269,1054,867,187,10485,60178,30700,"Tazewell County, Illinois",179,17,7.743722304
685,17181,Union County, Illinois,43.7,17458,461,35,0,35,176,56,120,128,36,92,122,76,46,2667,45464,24296,"Union County, Illinois",181,17,15.27666399
686,17183,Vermilion County, Illinois,40.1,79613,1749,277,13,264,497,74,423,319,141,178,656,431,225,15093,43552,22733,"Vermilion County, Illinois",183,17,18.95795913
687,17185,Wabash County, Illinois,42.6,11587,309,150,4,146,82,29,53,9,1,8,68,59,9,1376,46871,24697,"Wabash County, Illinois",185,17,11.87537758
688,17187,Warren County, Illinois,39.9,17611,1081,145,0,145,482,66,416,115,36,79,339,86,253,2533,44067,23350,"Warren County, Illinois",187,17,14.38305604
689,17189,Washington County, Illinois,42.8,14369,149,4,1,3,54,44,10,37,5,32,54,38,16,1580,54936,29548,"Washington County, Illinois",189,17,10.99589394
690,17191,Wayne County, Illinois,42.7,16517,156,58,0,58,3,2,1,65,56,9,30,30,0,2552,46903,24342,"Wayne County, Illinois",191,17,15.45074771
691,17193,White County, Illinois,44.5,14410,169,9,9,0,93,13,80,38,29,9,29,29,0,1960,43678,25065,"White County, Illinois",193,17,13.60166551
692,17195,Whiteside County, Illinois,42.8,57155,1657,53,5,48,575,257,318,334,186,148,695,525,170,6388,49151,26155,"Whiteside County, Illinois",195,17,11.17662497
693,17197,Will County, Illinois,37,685378,80514,4928,426,4502,23103,8026,15077,23607,11977,11630,28876,22614,6262,51976,77507,32311,"Will County, Illinois",197,17,7.583552434
694,17199,Williamson County, Illinois,40.9,67336,1364,217,46,171,476,147,329,277,184,93,394,325,69,9724,45902,25238,"Williamson County, Illinois",199,17,14.44101224
695,17201,Winnebago County, Illinois,39.3,288896,22634,2175,64,2111,6841,2100,4741,6659,3216,3443,6959,5416,1543,44086,49468,26187,"Winnebago County, Illinois",201,17,15.26016283
696,17203,Woodford County, Illinois,40,39123,427,17,0,17,134,56,78,97,84,13,179,160,19,2942,68040,32360,"Woodford County, Illinois",203,17,7.51987322
697,18001,Adams County, Indiana,33.7,34813,314,61,0,61,93,53,40,27,27,0,133,124,9,6140,47572,21173,"Adams County, Indiana",1,18,17.63708959
698,18003,Allen County, Indiana,35.6,365565,23277,3529,301,3228,9143,3132,6011,6264,3440,2824,4341,3285,1056,54545,49574,26058,"Allen County, Indiana",3,18,14.92073913
699,18005,Bartholomew County, Indiana,37.9,80203,7870,2409,3,2406,3485,230,3255,1169,500,669,807,643,164,9975,55874,28631,"Bartholomew County, Indiana",5,18,12.43719063
700,18007,Benton County, Indiana,40.5,8709,175,0,0,0,54,0,54,55,2,53,66,41,25,1096,48069,23181,"Benton County, Indiana",7,18,12.58468251
701,18009,Blackford County, Indiana,43.4,12364,149,22,22,0,45,19,26,15,15,0,67,50,17,1447,38791,21980,"Blackford County, Indiana",9,18,11.70333225
702,18011,Boone County, Indiana,38.9,61884,2225,313,25,288,1012,239,773,395,257,138,505,456,49,3719,72774,40487,"Boone County, Indiana",11,18,6.009630922
703,18013,Brown County, Indiana,48.3,14965,192,9,0,9,35,5,30,0,0,0,148,136,12,1882,56323,30279,"Brown County, Indiana",13,18,12.57601069
704,18015,Carroll County, Indiana,42.3,20007,551,41,38,3,238,83,155,62,5,57,210,168,42,2139,54140,25647,"Carroll County, Indiana",15,18,10.69125806
705,18017,Cass County, Indiana,40.5,38324,3359,413,51,362,1380,200,1180,915,272,643,651,367,284,5640,43918,22625,"Cass County, Indiana",17,18,14.71662666
706,18019,Clark County, Indiana,38.8,113993,3645,332,38,294,1854,597,1257,712,328,384,747,600,147,11153,51844,25693,"Clark County, Indiana",19,18,9.783934101
707,18021,Clay County, Indiana,40.4,26568,84,3,0,3,40,12,28,12,8,4,29,27,2,4358,49735,22913,"Clay County, Indiana",21,18,16.40319181
708,18023,Clinton County, Indiana,38.6,32692,2258,140,6,134,908,120,788,951,182,769,259,87,172,4052,50096,23260,"Clinton County, Indiana",23,18,12.3944696
709,18025,Crawford County, Indiana,43.3,10582,26,0,0,0,5,0,5,1,1,0,20,15,5,2034,41173,19756,"Crawford County, Indiana",25,18,19.22131922
710,18027,Daviess County, Indiana,34.6,32583,761,0,0,0,380,25,355,207,57,150,174,58,116,4329,47939,21472,"Daviess County, Indiana",27,18,13.28606942
711,18029,Dearborn County, Indiana,42.3,49552,590,57,3,54,159,32,127,100,63,37,274,248,26,4537,60834,28471,"Dearborn County, Indiana",29,18,9.156038101
712,18031,Decatur County, Indiana,39.1,26340,394,117,24,93,70,39,31,119,105,14,88,88,0,3375,51185,24175,"Decatur County, Indiana",31,18,12.81321185
713,18033,DeKalb County, Indiana,38.9,42489,557,19,0,19,181,82,99,138,19,119,219,157,62,5387,50398,25132,"DeKalb County, Indiana",33,18,12.67857563
714,18035,Delaware County, Indiana,35.1,116463,2353,644,94,550,527,64,463,676,268,408,506,448,58,23995,39537,21566,"Delaware County, Indiana",35,18,20.60311
715,18037,Dubois County, Indiana,40.9,42345,1919,319,53,266,845,207,638,392,116,276,363,261,102,3545,55154,27331,"Dubois County, Indiana",37,18,8.371708584
716,18039,Elkhart County, Indiana,35.3,201640,16816,1050,19,1031,6529,1063,5466,5999,1409,4590,3238,1790,1448,29381,49692,22387,"Elkhart County, Indiana",39,18,14.57101766
717,18041,Fayette County, Indiana,42.4,23608,159,67,36,31,39,30,9,4,4,0,49,42,7,4472,40851,21716,"Fayette County, Indiana",41,18,18.94273128
718,18043,Floyd County, Indiana,40,76290,1913,118,30,88,1062,227,835,337,139,198,396,272,124,9050,57494,29350,"Floyd County, Indiana",43,18,11.86262944
719,18045,Fountain County, Indiana,42.5,16741,259,21,0,21,150,24,126,53,31,22,35,29,6,2081,45924,25086,"Fountain County, Indiana",45,18,12.4305597
720,18047,Franklin County, Indiana,42.1,22887,254,167,13,154,69,38,31,0,0,0,18,18,0,2591,52128,24748,"Franklin County, Indiana",47,18,11.32083716
721,18049,Fulton County, Indiana,41.5,20412,588,0,0,0,230,22,208,183,83,100,175,92,83,2828,46310,23507,"Fulton County, Indiana",49,18,13.85459534
722,18051,Gibson County, Indiana,40.3,33684,285,43,0,43,57,13,44,54,25,29,131,66,65,3610,49669,25990,"Gibson County, Indiana",51,18,10.71725448
723,18053,Grant County, Indiana,39.8,68269,1057,190,93,97,261,71,190,341,280,61,265,234,31,12183,40272,20348,"Grant County, Indiana",53,18,17.84558145
724,18055,Greene County, Indiana,42.6,32633,173,29,0,29,65,44,21,9,9,0,70,60,10,4810,45153,23189,"Greene County, Indiana",55,18,14.73968069
725,18057,Hamilton County, Indiana,36.3,303042,22685,3796,139,3657,8041,2979,5062,5840,3910,1930,5008,4256,752,15381,87782,42361,"Hamilton County, Indiana",57,18,5.075534084
726,18059,Hancock County, Indiana,39.8,71955,1317,66,0,66,328,69,259,506,316,190,417,331,86,5274,68449,30011,"Hancock County, Indiana",59,18,7.329580988
727,18061,Harrison County, Indiana,42.5,39370,456,113,0,113,77,26,51,128,93,35,138,108,30,5139,52926,25319,"Harrison County, Indiana",61,18,13.05308611
728,18063,Hendricks County, Indiana,37.5,155817,7262,1168,214,954,2358,1132,1226,2042,1174,868,1694,1357,337,7834,73042,31335,"Hendricks County, Indiana",63,18,5.027692742
729,18065,Henry County, Indiana,42.5,48953,366,15,0,15,89,39,50,138,85,53,124,81,43,7349,44509,22182,"Henry County, Indiana",65,18,15.01235879
730,18067,Howard County, Indiana,41.5,82728,1717,203,44,159,408,177,231,478,274,204,628,399,229,13665,45928,25507,"Howard County, Indiana",67,18,16.51798666
731,18069,Huntington County, Indiana,40.1,36696,579,115,0,115,144,51,93,178,85,93,142,90,52,4227,47042,23396,"Huntington County, Indiana",69,18,11.51896664
732,18071,Jackson County, Indiana,38.3,43637,2203,572,22,550,1074,380,694,342,50,292,215,108,107,6317,48546,23098,"Jackson County, Indiana",71,18,14.47624722
733,18073,Jasper County, Indiana,39.1,33461,823,55,30,25,276,66,210,72,9,63,420,210,210,2488,55485,24839,"Jasper County, Indiana",73,18,7.435521951
734,18075,Jay County, Indiana,39.4,21196,260,9,0,9,93,13,80,84,40,44,74,51,23,3317,42322,20234,"Jay County, Indiana",75,18,15.64917909
735,18077,Jefferson County, Indiana,40.5,32482,492,98,6,92,218,0,218,36,31,5,140,116,24,4344,47065,23006,"Jefferson County, Indiana",77,18,13.37356074
736,18079,Jennings County, Indiana,39.6,28023,256,20,0,20,87,47,40,64,36,28,85,63,22,4217,47236,22374,"Jennings County, Indiana",79,18,15.04835314
737,18081,Johnson County, Indiana,37.4,147567,6379,1311,84,1227,2465,1060,1405,1450,980,470,1153,765,388,13473,63023,29877,"Johnson County, Indiana",81,18,9.130090061
738,18083,Knox County, Indiana,38.1,37956,505,84,0,84,198,147,51,81,54,27,142,118,24,4980,44624,22976,"Knox County, Indiana",83,18,13.12045526
739,18085,Kosciusko County, Indiana,37.8,78461,3331,376,70,306,1063,164,899,761,231,530,1131,795,336,8423,54482,26854,"Kosciusko County, Indiana",85,18,10.73526975
740,18087,LaGrange County, Indiana,31.1,38395,623,29,0,29,208,17,191,244,43,201,142,38,104,4728,53947,21774,"LaGrange County, Indiana",87,18,12.3141034
741,18089,Lake County, Indiana,38.2,489698,32902,2570,186,2384,7515,2554,4961,7940,3389,4551,14877,11859,3018,84905,50905,25483,"Lake County, Indiana",89,18,17.33823704
742,18091,LaPorte County, Indiana,40,110993,3457,206,0,206,1073,326,747,718,401,317,1460,1134,326,17621,48165,24340,"LaPorte County, Indiana",91,18,15.87577595
743,18093,Lawrence County, Indiana,42.4,45696,689,66,0,66,329,132,197,91,80,11,203,144,59,5771,46044,23743,"Lawrence County, Indiana",93,18,12.62911415
744,18095,Madison County, Indiana,40,129862,2387,226,7,219,981,281,700,557,203,354,623,412,211,20618,44795,22997,"Madison County, Indiana",95,18,15.87685389
745,18097,Marion County, Indiana,34.1,932142,80914,17177,1096,16081,35506,6671,28835,16263,5998,10265,11968,8670,3298,187586,43369,25208,"Marion County, Indiana",97,18,20.12418709
746,18099,Marshall County, Indiana,39.8,46833,2103,211,14,197,600,79,521,814,193,621,478,259,219,5351,49725,23372,"Marshall County, Indiana",99,18,11.4257041
747,18101,Martin County, Indiana,42.7,10218,54,14,0,14,30,22,8,0,0,0,10,10,0,1228,47457,23913,"Martin County, Indiana",101,18,12.01800744
748,18103,Miami County, Indiana,39.8,36093,377,86,14,72,99,24,75,78,37,41,114,82,32,5416,45646,21940,"Miami County, Indiana",103,18,15.00567977
749,18105,Monroe County, Indiana,28.6,143292,11579,5086,65,5021,3551,916,2635,1370,838,532,1572,1237,335,32044,43389,25488,"Monroe County, Indiana",105,18,22.36272786
750,18107,Montgomery County, Indiana,40.4,38108,1099,287,0,287,399,2,397,201,77,124,212,110,102,4635,50253,24095,"Montgomery County, Indiana",107,18,12.16280046
751,18109,Morgan County, Indiana,41.2,69504,845,82,12,70,218,129,89,155,84,71,390,308,82,8547,57521,26556,"Morgan County, Indiana",109,18,12.29713398
752,18111,Newton County, Indiana,42.9,14022,392,71,0,71,218,26,192,29,0,29,74,44,30,1833,50058,24061,"Newton County, Indiana",111,18,13.07231493
753,18113,Noble County, Indiana,38.4,47587,2107,53,0,53,523,139,384,777,229,548,754,344,410,5320,49657,23792,"Noble County, Indiana",113,18,11.17952382
754,18115,Ohio County, Indiana,46.2,6003,20,12,0,12,8,8,0,0,0,0,0,0,0,397,54653,25278,"Ohio County, Indiana",115,18,6.613359987
755,18117,Orange County, Indiana,40.9,19579,247,50,17,33,26,12,14,73,12,61,98,66,32,3154,41438,21295,"Orange County, Indiana",117,18,16.10909648
756,18119,Owen County, Indiana,44.3,21038,267,35,10,25,30,9,21,75,30,45,127,115,12,3074,45388,22675,"Owen County, Indiana",119,18,14.6116551
757,18121,Parke County, Indiana,41.6,17033,168,15,0,15,66,35,31,31,13,18,56,44,12,2312,42664,22247,"Parke County, Indiana",121,18,13.57365115
758,18123,Perry County, Indiana,41.1,19301,176,8,0,8,18,9,9,87,49,38,63,44,19,2561,47396,21634,"Perry County, Indiana",123,18,13.26874255
759,18125,Pike County, Indiana,43.4,12554,173,46,26,20,107,107,0,15,15,0,5,1,4,1244,48076,24367,"Pike County, Indiana",125,18,9.909192289
760,18127,Porter County, Indiana,39.4,167016,6608,833,42,791,1092,503,589,1396,642,754,3287,2652,635,17560,64874,30615,"Porter County, Indiana",127,18,10.51396273
761,18129,Posey County, Indiana,42.7,25527,144,51,3,48,65,35,30,1,1,0,27,27,0,2451,59918,30396,"Posey County, Indiana",129,18,9.601598308
762,18131,Pulaski County, Indiana,41.6,12910,104,26,0,26,21,8,13,10,0,10,47,38,9,1710,44884,23958,"Pulaski County, Indiana",131,18,13.24554609
763,18133,Putnam County, Indiana,37.8,37626,637,153,0,153,184,18,166,183,71,112,117,109,8,3298,52465,23040,"Putnam County, Indiana",133,18,8.765215542
764,18135,Randolph County, Indiana,42,25403,386,69,0,69,218,5,213,18,10,8,81,66,15,4319,42418,22817,"Randolph County, Indiana",135,18,17.00192891
765,18137,Ripley County, Indiana,40.8,28633,479,132,0,132,206,145,61,70,3,67,71,59,12,2834,52372,23980,"Ripley County, Indiana",137,18,9.89767052
766,18139,Rush County, Indiana,41.2,16873,179,36,0,36,59,45,14,59,39,20,25,19,6,2981,46380,24267,"Rush County, Indiana",139,18,17.66727908
767,18141,St. Joseph County, Indiana,36.4,267696,16899,3352,347,3005,5008,1024,3984,3806,1788,2018,4733,3556,1177,43926,46174,24748,"St. Joseph County, Indiana",141,18,16.4089116
768,18143,Scott County, Indiana,40.9,23734,325,139,0,139,39,16,23,94,38,56,53,50,3,3267,46368,23103,"Scott County, Indiana",143,18,13.76506278
769,18145,Shelby County, Indiana,41.5,44404,960,209,0,209,477,26,451,189,73,116,85,48,37,5446,52651,25478,"Shelby County, Indiana",145,18,12.26466084
770,18147,Spencer County, Indiana,42.8,20777,255,0,0,0,88,27,61,98,5,93,69,57,12,2013,54870,25914,"Spencer County, Indiana",147,18,9.688597969
771,18149,Starke County, Indiana,41.9,23069,380,1,0,1,45,9,36,45,45,0,289,184,105,3596,43401,21343,"Starke County, Indiana",149,18,15.58801855
772,18151,Steuben County, Indiana,42.1,34279,744,204,1,203,167,59,108,159,47,112,214,55,159,3407,50418,25497,"Steuben County, Indiana",151,18,9.939029727
773,18153,Sullivan County, Indiana,41,21026,168,0,0,0,40,20,20,16,12,4,112,99,13,3265,43786,20219,"Sullivan County, Indiana",153,18,15.52839342
774,18155,Switzerland County, Indiana,40.1,10484,128,48,0,48,6,0,6,33,33,0,41,41,0,2221,43456,20698,"Switzerland County, Indiana",155,18,21.18466234
775,18157,Tippecanoe County, Indiana,27.9,183397,20196,9346,65,9281,5174,876,4298,3150,1470,1680,2526,2073,453,36513,47406,24221,"Tippecanoe County, Indiana",157,18,19.90926787
776,18159,Tipton County, Indiana,44.5,15447,220,42,0,42,17,17,0,63,0,63,98,69,29,1328,54023,27556,"Tipton County, Indiana",159,18,8.597138603
777,18161,Union County, Indiana,43.1,7251,24,0,0,0,9,0,9,0,0,0,15,15,0,681,45104,22918,"Union County, Indiana",161,18,9.391808026
778,18163,Vanderburgh County, Indiana,37.7,181692,4811,993,20,973,1649,503,1146,638,459,179,1531,1316,215,29710,43311,25666,"Vanderburgh County, Indiana",163,18,16.35184818
779,18165,Vermillion County, Indiana,43,15752,102,58,0,58,14,6,8,0,0,0,30,30,0,2077,44409,22932,"Vermillion County, Indiana",165,18,13.18562722
780,18167,Vigo County, Indiana,36.1,108099,3676,1036,0,1036,1231,347,884,554,357,197,855,667,188,20053,41221,22079,"Vigo County, Indiana",167,18,18.55058789
781,18169,Wabash County, Indiana,42.1,32177,387,39,0,39,101,0,101,142,87,55,105,75,30,3839,47473,23745,"Wabash County, Indiana",169,18,11.93088231
782,18171,Warren County, Indiana,44.5,8309,35,20,0,20,11,0,11,0,0,0,4,3,1,639,58623,28690,"Warren County, Indiana",171,18,7.690456132
783,18173,Warrick County, Indiana,40.6,61427,1671,344,58,286,652,336,316,269,157,112,406,352,54,5757,61542,31021,"Warrick County, Indiana",173,18,9.372100217
784,18175,Washington County, Indiana,41,27792,130,0,0,0,31,18,13,21,11,10,78,65,13,4100,44883,22096,"Washington County, Indiana",175,18,14.75244675
785,18177,Wayne County, Indiana,40.9,67423,1504,376,28,348,450,90,360,331,160,171,347,281,66,12903,39691,22227,"Wayne County, Indiana",177,18,19.13738635
786,18179,Wells County, Indiana,40.7,27836,446,134,26,108,97,25,72,71,62,9,144,107,37,3421,51568,24544,"Wells County, Indiana",179,18,12.28984049
787,18181,White County, Indiana,42.3,24265,1047,122,12,110,468,60,408,301,68,233,156,97,59,2376,51547,25859,"White County, Indiana",181,18,9.791881311
788,18183,Whitley County, Indiana,41.3,33354,310,64,22,42,71,8,63,69,58,11,106,89,17,2876,54837,27062,"Whitley County, Indiana",183,18,8.622653955
789,19001,Adair County, Iowa,46,7330,91,9,3,6,18,6,12,18,5,13,46,8,38,687,48765,27358,"Adair County, Iowa",1,19,9.372442019
790,19003,Adams County, Iowa,47.2,3822,36,1,0,1,4,4,0,11,11,0,20,10,10,368,48598,26991,"Adams County, Iowa",3,19,9.628466771
791,19005,Allamakee County, Iowa,45.1,14001,638,117,14,103,353,106,247,107,32,75,61,46,15,1388,48089,27027,"Allamakee County, Iowa",5,19,9.913577602
792,19007,Appanoose County, Iowa,44.8,12602,104,20,0,20,31,0,31,22,12,10,31,19,12,1998,40817,23617,"Appanoose County, Iowa",7,19,15.85462625
793,19009,Audubon County, Iowa,48.3,5793,20,3,0,3,0,0,0,8,8,0,9,9,0,651,47048,30085,"Audubon County, Iowa",9,19,11.23770067
794,19011,Benton County, Iowa,41.8,25720,166,32,1,31,27,7,20,14,11,3,93,87,6,2324,61222,30888,"Benton County, Iowa",11,19,9.035769829
795,19013,Black Hawk County, Iowa,34.8,132821,7207,2072,196,1876,1653,674,979,2251,1531,720,1231,959,272,19605,50348,26571,"Black Hawk County, Iowa",13,19,14.76046709
796,19015,Boone County, Iowa,41.1,26411,281,9,0,9,80,3,77,90,57,33,102,72,30,2659,54513,28412,"Boone County, Iowa",15,19,10.06777479
797,19017,Bremer County, Iowa,38.9,24663,368,181,0,181,39,12,27,4,0,4,144,107,37,1677,64264,31001,"Bremer County, Iowa",17,19,6.799659409
798,19019,Buchanan County, Iowa,38.5,21031,252,65,0,65,39,14,25,75,53,22,73,72,1,1905,55881,30216,"Buchanan County, Iowa",19,19,9.058057154
799,19021,Buena Vista County, Iowa,35.4,20445,3625,548,4,544,1130,256,874,1002,439,563,945,538,407,2575,49942,25035,"Buena Vista County, Iowa",21,19,12.59476645
800,19023,Butler County, Iowa,43.7,14933,114,46,0,46,28,11,17,9,2,7,31,25,6,1289,52204,27085,"Butler County, Iowa",23,19,8.631889105
801,19025,Calhoun County, Iowa,45.4,9876,83,22,0,22,16,16,0,6,4,2,39,25,14,1364,44635,26210,"Calhoun County, Iowa",25,19,13.81125962
802,19027,Carroll County, Iowa,42,20555,190,27,0,27,42,5,37,37,20,17,84,82,2,1899,53785,28307,"Carroll County, Iowa",27,19,9.238628071
803,19029,Cass County, Iowa,44.6,13433,170,4,0,4,31,25,6,35,16,19,100,86,14,1985,45469,26411,"Cass County, Iowa",29,19,14.77704161
804,19031,Cedar County, Iowa,42.2,18389,215,23,23,0,88,27,61,66,66,0,38,29,9,1162,60435,29271,"Cedar County, Iowa",31,19,6.318995051
805,19033,Cerro Gordo County, Iowa,44.3,43303,994,156,11,145,236,133,103,191,51,140,411,337,74,5422,47788,28763,"Cerro Gordo County, Iowa",33,19,12.52107244
806,19035,Cherokee County, Iowa,46.5,11752,149,46,0,46,41,9,32,20,6,14,42,38,4,1321,51590,28783,"Cherokee County, Iowa",35,19,11.24063989
807,19037,Chickasaw County, Iowa,44.2,12164,179,64,0,64,71,9,62,19,19,0,25,15,10,1073,48013,26915,"Chickasaw County, Iowa",37,19,8.821111476
808,19039,Clarke County, Iowa,39.7,9273,478,29,0,29,218,5,213,68,0,68,163,74,89,1454,46510,23742,"Clarke County, Iowa",39,19,15.67993098
809,19041,Clay County, Iowa,41.7,16478,281,51,0,51,68,41,27,101,9,92,61,58,3,1907,48888,27883,"Clay County, Iowa",41,19,11.57300643
810,19043,Clayton County, Iowa,45.9,17735,343,60,0,60,137,84,53,34,5,29,112,91,21,1841,48482,26960,"Clayton County, Iowa",43,19,10.38060333
811,19045,Clinton County, Iowa,42.2,47972,865,241,15,226,213,131,82,101,46,55,310,238,72,6405,50067,27116,"Clinton County, Iowa",45,19,13.3515384
812,19047,Crawford County, Iowa,37.9,17147,2286,293,27,266,734,111,623,812,234,578,447,147,300,3681,49699,26693,"Crawford County, Iowa",47,19,21.46731207
813,19049,Dallas County, Iowa,35,78074,5853,1463,162,1301,1935,561,1374,1242,575,667,1213,935,278,4424,78918,40468,"Dallas County, Iowa",49,19,5.666419038
814,19051,Davis County, Iowa,37.6,8768,41,0,0,0,18,13,5,3,0,3,20,20,0,1617,49696,24405,"Davis County, Iowa",51,19,18.44206204
815,19053,Decatur County, Iowa,36.8,8210,141,49,0,49,51,3,48,8,0,8,33,29,4,1552,38467,20808,"Decatur County, Iowa",53,19,18.90377588
816,19055,Delaware County, Iowa,43.2,17445,176,32,9,23,60,0,60,16,13,3,68,24,44,1645,59452,29978,"Delaware County, Iowa",55,19,9.429635999
817,19057,Des Moines County, Iowa,42.2,40114,631,169,2,167,84,0,84,177,86,91,201,189,12,6574,44516,25151,"Des Moines County, Iowa",57,19,16.38829336
818,19059,Dickinson County, Iowa,48.8,17046,172,43,6,37,49,20,29,9,3,6,71,36,35,1153,57914,36042,"Dickinson County, Iowa",59,19,6.764050217
819,19061,Dubuque County, Iowa,38.5,96359,2364,515,47,468,697,163,534,575,384,191,577,451,126,11616,56154,28526,"Dubuque County, Iowa",61,19,12.05491962
820,19063,Emmet County, Iowa,42.5,9820,376,35,0,35,202,37,165,46,3,43,93,93,0,1223,45536,27807,"Emmet County, Iowa",63,19,12.45417515
821,19065,Fayette County, Iowa,43.1,20391,248,131,0,131,14,14,0,20,12,8,83,65,18,2581,47711,26002,"Fayette County, Iowa",65,19,12.657545
822,19067,Floyd County, Iowa,44.5,16004,415,9,0,9,96,46,50,141,61,80,169,101,68,2219,46406,26929,"Floyd County, Iowa",67,19,13.86528368
823,19069,Franklin County, Iowa,42.5,10393,330,48,0,48,142,36,106,64,9,55,76,57,19,1509,47524,24909,"Franklin County, Iowa",69,19,14.51938805
824,19071,Fremont County, Iowa,46.3,7019,101,20,0,20,16,3,13,50,43,7,15,14,1,713,52922,29553,"Fremont County, Iowa",71,19,10.15814219
825,19073,Greene County, Iowa,45,9083,121,6,0,6,14,2,12,41,7,34,60,39,21,950,47264,26103,"Greene County, Iowa",73,19,10.45909942
826,19075,Grundy County, Iowa,42.5,12373,74,1,0,1,30,21,9,7,0,7,36,33,3,722,61606,32953,"Grundy County, Iowa",75,19,5.835286511
827,19077,Guthrie County, Iowa,45.9,10691,117,19,0,19,43,1,42,36,8,28,19,6,13,1116,52702,29938,"Guthrie County, Iowa",77,19,10.43868675
828,19079,Hamilton County, Iowa,43,15227,689,109,3,106,169,1,168,153,131,22,258,207,51,1612,53970,28076,"Hamilton County, Iowa",79,19,10.58645826
829,19081,Hancock County, Iowa,44.2,11006,194,31,6,25,69,0,69,9,6,3,85,51,34,1026,54813,27732,"Hancock County, Iowa",81,19,9.322187898
830,19083,Hardin County, Iowa,44.4,17324,441,98,0,98,146,81,65,81,15,66,116,73,43,1328,51821,27657,"Hardin County, Iowa",83,19,7.665666128
831,19085,Harrison County, Iowa,44,14335,144,0,0,0,17,0,17,46,28,18,81,58,23,1474,55845,27984,"Harrison County, Iowa",85,19,10.28252529
832,19087,Henry County, Iowa,40.7,19941,658,87,27,60,191,40,151,100,64,36,280,217,63,2508,49606,24380,"Henry County, Iowa",87,19,12.57710245
833,19089,Howard County, Iowa,42.1,9430,52,1,0,1,3,0,3,23,23,0,25,21,4,1063,49199,25567,"Howard County, Iowa",89,19,11.27253446
834,19091,Humboldt County, Iowa,43.3,9607,191,13,5,8,161,31,130,1,1,0,16,0,16,1286,47478,28654,"Humboldt County, Iowa",91,19,13.38607266
835,19093,Ida County, Iowa,44.7,7041,70,13,0,13,7,0,7,1,1,0,49,34,15,760,49957,29750,"Ida County, Iowa",93,19,10.79392132
836,19095,Iowa County, Iowa,41.8,16326,190,1,0,1,26,15,11,121,29,92,42,36,6,1575,55099,28640,"Iowa County, Iowa",95,19,9.647188534
837,19097,Jackson County, Iowa,44.6,19529,173,13,0,13,39,4,35,49,38,11,72,72,0,2653,49115,25865,"Jackson County, Iowa",97,19,13.58492498
838,19099,Jasper County, Iowa,42.6,36715,402,29,1,28,95,32,63,83,50,33,195,172,23,3227,55503,26507,"Jasper County, Iowa",99,19,8.789323165
839,19101,Jefferson County, Iowa,41.1,17662,2136,1443,26,1417,329,74,255,206,76,130,158,77,81,2504,45257,25120,"Jefferson County, Iowa",101,19,14.17732986
840,19103,Johnson County, Iowa,29.9,142006,14759,4765,171,4594,4730,1026,3704,3214,1921,1293,2050,1547,503,23911,56808,31981,"Johnson County, Iowa",103,19,16.83802093
841,19105,Jones County, Iowa,43.8,20481,368,86,0,86,104,7,97,123,87,36,55,47,8,2034,55507,27891,"Jones County, Iowa",105,19,9.931155705
842,19107,Keokuk County, Iowa,44.1,10234,80,32,2,30,21,0,21,5,0,5,22,20,2,1296,45227,24650,"Keokuk County, Iowa",107,19,12.66367012
843,19109,Kossuth County, Iowa,45.9,15226,192,40,6,34,72,32,40,20,10,10,60,33,27,1454,54231,29086,"Kossuth County, Iowa",109,19,9.54945488
844,19111,Lee County, Iowa,43.4,35172,434,35,0,35,52,0,52,157,50,107,190,139,51,5615,44568,23470,"Lee County, Iowa",111,19,15.9644035
845,19113,Linn County, Iowa,37.2,218076,7685,1743,53,1690,2402,741,1661,1407,817,590,2133,1766,367,19912,60989,31854,"Linn County, Iowa",113,19,9.130761753
846,19115,Louisa County, Iowa,40.7,11251,1058,217,16,201,310,91,219,209,26,183,322,151,171,1392,51615,26093,"Louisa County, Iowa",115,19,12.37223358
847,19117,Lucas County, Iowa,45.5,8700,237,0,0,0,11,0,11,181,15,166,45,29,16,910,48768,26119,"Lucas County, Iowa",117,19,10.45977011
848,19119,Lyon County, Iowa,38.2,11730,130,34,0,34,43,18,25,32,11,21,21,16,5,675,59888,27874,"Lyon County, Iowa",119,19,5.754475703
849,19121,Madison County, Iowa,40.9,15661,272,30,4,26,173,46,127,14,5,9,55,26,29,1054,60326,29430,"Madison County, Iowa",121,19,6.730093864
850,19123,Mahaska County, Iowa,39.9,22324,423,182,0,182,52,39,13,118,66,52,71,65,6,3010,49599,25823,"Mahaska County, Iowa",123,19,13.48324673
851,19125,Marion County, Iowa,39.2,33197,774,74,17,57,138,71,67,203,178,25,359,286,73,3108,57412,27020,"Marion County, Iowa",125,19,9.362291773
852,19127,Marshall County, Iowa,38.7,40735,5283,807,20,787,2442,263,2179,1042,237,805,992,632,360,4267,54193,25197,"Marshall County, Iowa",127,19,10.47502148
853,19129,Mills County, Iowa,42.8,14841,119,1,0,1,10,10,0,16,16,0,92,70,22,1203,66203,29492,"Mills County, Iowa",129,19,8.105922781
854,19131,Mitchell County, Iowa,43.7,10757,80,17,0,17,22,0,22,2,0,2,39,39,0,970,52564,25990,"Mitchell County, Iowa",131,19,9.017384029
855,19133,Monona County, Iowa,47,9013,99,17,1,16,47,18,29,7,2,5,28,2,26,1273,41455,26394,"Monona County, Iowa",133,19,14.12404305
856,19135,Monroe County, Iowa,43.2,7964,111,27,19,8,57,14,43,17,0,17,10,10,0,1032,47515,25233,"Monroe County, Iowa",135,19,12.95831241
857,19137,Montgomery County, Iowa,45.2,10380,171,32,0,32,81,10,71,13,0,13,45,15,30,1529,42641,23626,"Montgomery County, Iowa",137,19,14.73025048
858,19139,Muscatine County, Iowa,38,42949,2707,418,84,334,561,91,470,908,371,537,820,608,212,4802,55971,27029,"Muscatine County, Iowa",139,19,11.18070269
859,19141,O'Brien County, Iowa,43.4,14055,360,38,0,38,23,4,19,210,56,154,89,61,28,1278,52474,30933,"O'Brien County, Iowa",141,19,9.09284952
860,19143,Osceola County, Iowa,44.3,6154,258,38,0,38,109,1,108,74,13,61,37,33,4,631,48457,25936,"Osceola County, Iowa",143,19,10.25349366
861,19145,Page County, Iowa,44,15552,398,136,7,129,110,36,74,117,76,41,35,35,0,2193,46128,25461,"Page County, Iowa",145,19,14.10108025
862,19147,Palo Alto County, Iowa,42.6,9155,206,95,0,95,46,0,46,17,1,16,48,22,26,797,49109,26776,"Palo Alto County, Iowa",147,19,8.705625341
863,19149,Plymouth County, Iowa,41.5,24972,633,167,32,135,214,36,178,44,44,0,208,142,66,2111,60339,28975,"Plymouth County, Iowa",149,19,8.453467884
864,19151,Pocahontas County, Iowa,47.3,7061,166,15,0,15,71,6,65,57,22,35,23,23,0,885,46250,27599,"Pocahontas County, Iowa",151,19,12.53363546
865,19153,Polk County, Iowa,35,459159,40059,6940,516,6424,13492,4054,9438,11207,6319,4888,8420,5960,2460,55972,61684,32232,"Polk County, Iowa",153,19,12.19011279
866,19155,Pottawattamie County, Iowa,39.3,93198,3422,647,50,597,1287,485,802,673,355,318,815,514,301,10668,53260,27948,"Pottawattamie County, Iowa",155,19,11.44659757
867,19157,Poweshiek County, Iowa,41,18622,648,233,0,233,171,47,124,139,63,76,105,73,32,1687,50725,26583,"Poweshiek County, Iowa",157,19,9.059177317
868,19159,Ringgold County, Iowa,46,5054,35,15,0,15,12,9,3,0,0,0,8,4,4,533,46927,26175,"Ringgold County, Iowa",159,19,10.5461021
869,19161,Sac County, Iowa,45.9,10034,143,1,0,1,10,2,8,93,30,63,39,30,9,997,49570,27088,"Sac County, Iowa",161,19,9.936216863
870,19163,Scott County, Iowa,37.7,171116,6577,1568,152,1416,1950,571,1379,1662,1250,412,1397,1073,324,20413,56454,30037,"Scott County, Iowa",163,19,11.92933449
871,19165,Shelby County, Iowa,47,11944,269,2,0,2,164,9,155,40,26,14,63,63,0,1174,52757,28178,"Shelby County, Iowa",165,19,9.829202947
872,19167,Sioux County, Iowa,33.3,34621,2119,520,13,507,889,144,745,352,64,288,358,215,143,2444,63466,27037,"Sioux County, Iowa",167,19,7.059299269
873,19169,Story County, Iowa,25.8,94834,8761,3942,35,3907,2520,274,2246,1104,691,413,1195,1129,66,19039,51201,26032,"Story County, Iowa",169,19,20.07613303
874,19171,Tama County, Iowa,43.2,17423,609,47,0,47,126,29,97,155,34,121,281,153,128,2195,53833,26144,"Tama County, Iowa",171,19,12.59828962
875,19173,Taylor County, Iowa,43.4,6209,217,36,0,36,107,6,101,59,39,20,15,11,4,802,46510,26188,"Taylor County, Iowa",173,19,12.91673377
876,19175,Union County, Iowa,40.3,12539,230,48,14,34,96,21,75,26,19,7,60,58,2,1585,45934,25140,"Union County, Iowa",175,19,12.64056145
877,19177,Van Buren County, Iowa,44.8,7380,75,0,0,0,25,12,13,2,0,2,48,47,1,1060,46769,23765,"Van Buren County, Iowa",177,19,14.36314363
878,19179,Wapello County, Iowa,39.5,35242,2776,573,27,546,1052,240,812,623,145,478,528,225,303,6033,42494,23116,"Wapello County, Iowa",179,19,17.11877873
879,19181,Warren County, Iowa,38.2,48170,503,62,14,48,147,56,91,139,89,50,155,92,63,3402,67090,31525,"Warren County, Iowa",181,19,7.062487025
880,19183,Washington County, Iowa,41.2,22115,660,102,0,102,177,100,77,91,13,78,290,264,26,1947,56864,27933,"Washington County, Iowa",183,19,8.8039792
881,19185,Wayne County, Iowa,43.9,6403,55,3,0,3,14,14,0,12,0,12,26,24,2,924,42088,22461,"Wayne County, Iowa",185,19,14.43073559
882,19187,Webster County, Iowa,39.5,37050,1071,374,28,346,306,36,270,269,123,146,122,113,9,5362,42196,23921,"Webster County, Iowa",187,19,14.47233468
883,19189,Winnebago County, Iowa,42.8,10580,214,39,2,37,50,8,42,49,34,15,76,29,47,1023,49278,25917,"Winnebago County, Iowa",189,19,9.669187146
884,19191,Winneshiek County, Iowa,40.6,20789,420,48,0,48,232,17,215,47,25,22,93,66,27,1472,57009,27240,"Winneshiek County, Iowa",191,19,7.080667661
885,19193,Woodbury County, Iowa,35.3,102426,8917,1246,123,1123,2891,602,2289,2889,1407,1482,1891,1023,868,14084,49010,24469,"Woodbury County, Iowa",193,19,13.75041493
886,19195,Worth County, Iowa,44.6,7562,63,2,0,2,10,5,5,5,5,0,46,35,11,775,49472,25661,"Worth County, Iowa",195,19,10.24861148
887,19197,Wright County, Iowa,44.4,12891,686,97,0,97,234,11,223,246,57,189,109,68,41,1625,46071,27111,"Wright County, Iowa",197,19,12.60569389
888,20001,Allen County, Kansas,41.7,12951,63,7,5,2,1,0,1,25,16,9,30,30,0,1916,40911,21577,"Allen County, Kansas",1,20,14.79422438
889,20003,Anderson County, Kansas,42,7858,39,0,0,0,18,15,3,7,0,7,14,14,0,1171,42146,21851,"Anderson County, Kansas",3,20,14.90201069
890,20005,Atchison County, Kansas,36.6,16557,194,29,0,29,60,55,5,41,21,20,64,57,7,2941,46103,23151,"Atchison County, Kansas",5,20,17.76287975
891,20007,Barber County, Kansas,44.3,4831,77,5,5,0,17,7,10,55,25,30,0,0,0,674,49455,26040,"Barber County, Kansas",7,20,13.95156282
892,20009,Barton County, Kansas,40.1,27214,1459,66,0,66,363,84,279,828,150,678,202,70,132,4137,44449,25474,"Barton County, Kansas",9,20,15.2017344
893,20011,Bourbon County, Kansas,38.1,14751,262,40,27,13,191,121,70,10,10,0,21,13,8,2489,41529,21158,"Bourbon County, Kansas",11,20,16.87343231
894,20013,Brown County, Kansas,42.9,9810,99,5,0,5,43,10,33,16,11,5,35,35,0,1408,44672,23247,"Brown County, Kansas",13,20,14.35270133
895,20015,Butler County, Kansas,38,66264,1560,163,4,159,356,196,160,459,163,296,582,509,73,6171,60338,27888,"Butler County, Kansas",15,20,9.312749004
896,20017,Chase County, Kansas,46.2,2694,48,4,0,4,2,0,2,19,6,13,23,7,16,324,41889,24353,"Chase County, Kansas",17,20,12.02672606
897,20019,Chautauqua County, Kansas,49,3470,12,0,0,0,0,0,0,4,4,0,8,8,0,504,37927,23398,"Chautauqua County, Kansas",19,20,14.52449568
898,20021,Cherokee County, Kansas,41.7,20737,182,7,3,4,21,6,15,74,13,61,80,73,7,3315,41240,20371,"Cherokee County, Kansas",21,20,15.98591889
899,20023,Cheyenne County, Kansas,48.5,2679,75,27,0,27,12,5,7,18,0,18,18,18,0,234,46058,27608,"Cheyenne County, Kansas",23,20,8.734602464
900,20025,Clark County, Kansas,44.5,2131,99,0,0,0,48,14,34,48,13,35,3,0,3,281,42976,24322,"Clark County, Kansas",25,20,13.18629751
901,20027,Clay County, Kansas,42,8346,144,5,0,5,26,14,12,47,0,47,66,53,13,797,53041,27715,"Clay County, Kansas",27,20,9.549484783
902,20029,Cloud County, Kansas,41.5,9302,222,83,0,83,28,10,18,0,0,0,111,110,1,1154,40947,24677,"Cloud County, Kansas",29,20,12.40593421
903,20031,Coffey County, Kansas,44.4,8433,89,20,0,20,0,0,0,24,8,16,45,30,15,892,57442,30242,"Coffey County, Kansas",31,20,10.57749318
904,20033,Comanche County, Kansas,47,1898,61,0,0,0,0,0,0,60,0,60,1,1,0,156,43542,24574,"Comanche County, Kansas",33,20,8.219178082
905,20035,Cowley County, Kansas,38,35977,1368,342,38,304,268,103,165,251,131,120,507,340,167,5546,44960,22249,"Cowley County, Kansas",35,20,15.41540429
906,20037,Crawford County, Kansas,32.5,39281,1517,637,5,632,395,104,291,327,210,117,158,98,60,8176,37607,20642,"Crawford County, Kansas",37,20,20.81413406
907,20039,Decatur County, Kansas,52.1,2886,33,11,0,11,0,0,0,0,0,0,22,22,0,373,41362,29729,"Decatur County, Kansas",39,20,12.92446292
908,20041,Dickinson County, Kansas,41.7,19384,362,23,3,20,117,22,95,64,40,24,158,145,13,2131,48093,24454,"Dickinson County, Kansas",41,20,10.99360297
909,20043,Doniphan County, Kansas,39.6,7793,62,17,2,15,20,11,9,11,0,11,14,3,11,873,49375,23986,"Doniphan County, Kansas",43,20,11.20236109
910,20045,Douglas County, Kansas,29.1,116352,7684,3209,127,3082,2010,473,1537,1127,690,437,1338,1083,255,20668,52698,28302,"Douglas County, Kansas",45,20,17.76333883
911,20047,Edwards County, Kansas,45.4,2975,357,1,0,1,128,22,106,92,18,74,136,74,62,318,48684,26567,"Edwards County, Kansas",47,20,10.68907563
912,20049,Elk County, Kansas,50.8,2635,43,3,0,3,9,6,3,9,9,0,22,19,3,449,37393,22040,"Elk County, Kansas",49,20,17.0398482
913,20051,Ellis County, Kansas,32,29032,1001,343,0,343,222,97,125,211,149,62,225,184,41,4008,50140,27103,"Ellis County, Kansas",51,20,13.80545605
914,20053,Ellsworth County, Kansas,43.8,6375,83,7,0,7,28,7,21,13,0,13,35,12,23,460,49134,23851,"Ellsworth County, Kansas",53,20,7.215686275
915,20055,Finney County, Kansas,30.5,36983,7870,719,28,691,2668,472,2196,2064,708,1356,2419,1361,1058,5790,50712,22551,"Finney County, Kansas",55,20,15.65584187
916,20057,Ford County, Kansas,31.1,34492,9363,1423,77,1346,3035,357,2678,3501,954,2547,1404,796,608,5871,49688,20749,"Ford County, Kansas",57,20,17.02133828
917,20059,Franklin County, Kansas,39.3,25663,301,70,5,65,50,0,50,73,4,69,108,102,6,3357,51465,24597,"Franklin County, Kansas",59,20,13.08108951
918,20061,Geary County, Kansas,26.2,36818,2974,151,11,140,1147,515,632,568,335,233,1108,813,295,4482,45243,21309,"Geary County, Kansas",61,20,12.17339345
919,20063,Gove County, Kansas,47.7,2682,48,12,0,12,8,1,7,14,6,8,14,4,10,241,46681,26746,"Gove County, Kansas",63,20,8.985831469
920,20065,Graham County, Kansas,50.3,2577,48,33,0,33,0,0,0,5,0,5,10,2,8,262,45982,27569,"Graham County, Kansas",65,20,10.16686069
921,20067,Grant County, Kansas,32.6,7748,1396,22,0,22,683,19,664,438,49,389,253,120,133,870,54919,24173,"Grant County, Kansas",67,20,11.22870418
922,20069,Gray County, Kansas,35.8,6037,578,51,0,51,230,21,209,184,35,149,113,98,15,495,59629,26536,"Gray County, Kansas",69,20,8.199436806
923,20071,Greeley County, Kansas,49,1235,86,15,0,15,26,1,25,31,15,16,14,14,0,85,47000,26040,"Greeley County, Kansas",71,20,6.882591093
924,20073,Greenwood County, Kansas,48.6,6304,30,0,0,0,18,0,18,0,0,0,12,8,4,890,39671,23972,"Greenwood County, Kansas",73,20,14.1180203
925,20075,Hamilton County, Kansas,32.8,2567,507,98,14,84,119,0,119,217,27,190,73,46,27,282,48523,21863,"Hamilton County, Kansas",75,20,10.98558629
926,20077,Harper County, Kansas,43.2,5798,102,7,0,7,39,0,39,29,3,26,27,22,5,771,46886,25944,"Harper County, Kansas",77,20,13.29768886
927,20079,Harvey County, Kansas,38.7,34814,1566,300,0,300,451,83,368,458,263,195,357,226,131,4180,52463,25320,"Harvey County, Kansas",79,20,12.00666399
928,20081,Haskell County, Kansas,36.2,4087,768,17,7,10,210,18,192,329,62,267,212,102,110,521,55453,22886,"Haskell County, Kansas",81,20,12.74773673
929,20083,Hodgeman County, Kansas,48.9,1919,81,32,0,32,22,9,13,13,4,9,14,7,7,108,56250,33661,"Hodgeman County, Kansas",83,20,5.627931214
930,20085,Jackson County, Kansas,41.3,13365,111,6,0,6,31,0,31,8,6,2,66,56,10,1075,54700,26027,"Jackson County, Kansas",85,20,8.043396932
931,20087,Jefferson County, Kansas,43.7,18880,109,0,0,0,33,5,28,25,23,2,51,27,24,1690,56777,26328,"Jefferson County, Kansas",87,20,8.951271186
932,20089,Jewell County, Kansas,51.2,3003,42,1,0,1,4,0,4,3,3,0,34,19,15,454,37750,23282,"Jewell County, Kansas",89,20,15.11821512
933,20091,Johnson County, Kansas,37.1,572428,47317,7163,379,6784,18206,5241,12965,10508,6022,4486,11440,9819,1621,34189,78186,41415,"Johnson County, Kansas",91,20,5.972628872
934,20093,Kearny County, Kansas,35.1,3943,427,36,0,36,112,0,112,170,44,126,109,69,40,483,49396,23213,"Kearny County, Kansas",93,20,12.24955618
935,20095,Kingman County, Kansas,45.4,7697,70,0,0,0,52,0,52,1,0,1,17,14,3,662,56142,28911,"Kingman County, Kansas",95,20,8.60075354
936,20097,Kiowa County, Kansas,40.8,2520,120,23,0,23,55,14,41,23,11,12,19,7,12,254,44896,24895,"Kiowa County, Kansas",97,20,10.07936508
937,20099,Labette County, Kansas,40.9,20833,168,14,0,14,59,0,59,67,18,49,28,28,0,3699,41851,21648,"Labette County, Kansas",99,20,17.75548409
938,20101,Lane County, Kansas,43,1687,31,0,0,0,1,0,1,9,9,0,21,11,10,148,58077,31329,"Lane County, Kansas",101,20,8.772969769
939,20103,Leavenworth County, Kansas,37.3,78785,2397,516,19,497,527,200,327,571,277,294,783,609,174,7238,66046,28743,"Leavenworth County, Kansas",103,20,9.187027988
940,20105,Lincoln County, Kansas,46.1,3134,35,7,0,7,0,0,0,9,0,9,19,5,14,325,49583,25070,"Lincoln County, Kansas",105,20,10.37013401
941,20107,Linn County, Kansas,43.4,9524,37,0,0,0,15,0,15,0,0,0,22,21,1,1413,45790,27368,"Linn County, Kansas",107,20,14.83620328
942,20109,Logan County, Kansas,41.3,2800,53,3,0,3,22,22,0,8,5,3,20,2,18,264,48205,27837,"Logan County, Kansas",109,20,9.428571429
943,20111,Lyon County, Kansas,32.8,33401,3062,608,6,602,777,185,592,892,202,690,785,328,457,6671,40611,23317,"Lyon County, Kansas",111,20,19.97245591
944,20113,McPherson County, Kansas,41.8,29164,415,43,18,25,220,60,160,87,35,52,65,25,40,1833,56783,28722,"McPherson County, Kansas",113,20,6.28514607
945,20115,Marion County, Kansas,45.1,12213,174,36,0,36,36,1,35,20,20,0,82,74,8,1243,47926,24234,"Marion County, Kansas",115,20,10.17767952
946,20117,Marshall County, Kansas,45.2,9963,122,10,0,10,41,18,23,18,18,0,53,53,0,923,47532,26978,"Marshall County, Kansas",117,20,9.264277828
947,20119,Meade County, Kansas,39.6,4310,379,28,0,28,139,40,99,91,25,66,121,51,70,591,52960,24253,"Meade County, Kansas",119,20,13.71229698
948,20121,Miami County, Kansas,40.8,32787,301,67,0,67,54,13,41,36,14,22,144,135,9,3079,63353,30184,"Miami County, Kansas",121,20,9.390917132
949,20123,Mitchell County, Kansas,43.8,6299,106,41,0,41,10,0,10,27,20,7,28,20,8,697,49755,27432,"Mitchell County, Kansas",123,20,11.06524845
950,20125,Montgomery County, Kansas,40,33765,969,257,48,209,395,47,348,121,20,101,196,168,28,6225,42646,22181,"Montgomery County, Kansas",125,20,18.43625056
951,20127,Morris County, Kansas,47.7,5694,77,24,0,24,14,4,10,18,4,14,21,12,9,492,48551,25135,"Morris County, Kansas",127,20,8.640674394
952,20129,Morton County, Kansas,41,3033,373,0,0,0,173,4,169,138,19,119,62,33,29,297,44100,23115,"Morton County, Kansas",129,20,9.792284866
953,20131,Nemaha County, Kansas,41.2,10177,114,16,0,16,44,23,21,12,12,0,42,36,6,1078,50400,26208,"Nemaha County, Kansas",131,20,10.59251253
954,20133,Neosho County, Kansas,39.9,16358,215,9,0,9,147,34,113,17,9,8,42,26,16,3113,43867,22759,"Neosho County, Kansas",133,20,19.03044382
955,20135,Ness County, Kansas,46.8,3047,152,56,0,56,60,24,36,23,0,23,13,10,3,338,47298,28184,"Ness County, Kansas",135,20,11.09287824
956,20137,Norton County, Kansas,43.7,5558,162,2,0,2,95,0,95,38,2,36,27,5,22,419,47651,23039,"Norton County, Kansas",137,20,7.538682979
957,20139,Osage County, Kansas,42.7,16001,117,11,7,4,30,6,24,37,4,33,39,30,9,1826,52171,25880,"Osage County, Kansas",139,20,11.41178676
958,20141,Osborne County, Kansas,48.3,3746,44,22,0,22,15,11,4,0,0,0,7,7,0,631,41432,27824,"Osborne County, Kansas",141,20,16.84463428
959,20143,Ottawa County, Kansas,42.2,6004,40,15,0,15,0,0,0,3,3,0,22,22,0,501,52241,26749,"Ottawa County, Kansas",143,20,8.344437042
960,20145,Pawnee County, Kansas,43.7,6840,215,0,0,0,92,0,92,25,1,24,98,98,0,423,46227,25193,"Pawnee County, Kansas",145,20,6.184210526
961,20147,Phillips County, Kansas,44.9,5484,82,12,12,0,29,1,28,22,0,22,19,19,0,503,45940,25364,"Phillips County, Kansas",147,20,9.172137126
962,20149,Pottawatomie County, Kansas,34.8,22920,622,73,0,73,204,49,155,160,47,113,185,114,71,2045,62500,27199,"Pottawatomie County, Kansas",149,20,8.922338569
963,20151,Pratt County, Kansas,38.8,9729,329,61,0,61,152,33,119,23,3,20,93,23,70,1226,48995,25745,"Pratt County, Kansas",151,20,12.60150067
964,20153,Rawlins County, Kansas,50.3,2557,65,27,0,27,22,2,20,13,1,12,3,0,3,204,49327,27250,"Rawlins County, Kansas",153,20,7.978099335
965,20155,Reno County, Kansas,40.1,63803,1840,246,43,203,503,59,444,482,166,316,609,360,249,8727,46000,24313,"Reno County, Kansas",155,20,13.67804022
966,20157,Republic County, Kansas,50.9,4768,59,25,2,23,16,6,10,0,0,0,18,8,10,530,41489,26029,"Republic County, Kansas",157,20,11.11577181
967,20159,Rice County, Kansas,37.7,9949,368,65,0,65,147,30,117,88,12,76,68,21,47,1404,46335,22596,"Rice County, Kansas",159,20,14.11197105
968,20161,Riley County, Kansas,24.9,75026,6302,2598,135,2463,1908,470,1438,900,619,281,896,793,103,14347,46609,25087,"Riley County, Kansas",161,20,19.12270413
969,20163,Rooks County, Kansas,43.7,5160,93,18,0,18,0,0,0,37,30,7,38,37,1,673,46750,24919,"Rooks County, Kansas",163,20,13.04263566
970,20165,Rush County, Kansas,48.3,3144,47,0,0,0,0,0,0,13,11,2,34,31,3,230,40395,25002,"Rush County, Kansas",165,20,7.315521628
971,20167,Russell County, Kansas,47.4,6988,61,0,0,0,18,2,16,0,0,0,43,5,38,893,42656,24181,"Russell County, Kansas",167,20,12.7790498
972,20169,Saline County, Kansas,37.6,55547,2981,178,6,172,1238,294,944,609,351,258,956,648,308,7986,48497,26477,"Saline County, Kansas",169,20,14.37701406
973,20171,Scott County, Kansas,41.5,4958,343,4,4,0,218,13,205,75,64,11,46,46,0,250,61886,31280,"Scott County, Kansas",171,20,5.042355789
974,20173,Sedgwick County, Kansas,34.8,508221,43523,5743,578,5165,12177,3603,8574,12710,5818,6892,12893,9487,3406,75476,51157,26672,"Sedgwick County, Kansas",173,20,14.85101954
975,20175,Seward County, Kansas,29.2,23185,7069,744,32,712,2273,183,2090,2209,802,1407,1843,1075,768,4285,47507,20844,"Seward County, Kansas",175,20,18.48177701
976,20177,Shawnee County, Kansas,38.8,178567,7880,1145,150,995,2620,691,1929,2272,646,1626,1843,1246,597,25190,52088,27534,"Shawnee County, Kansas",177,20,14.10674985
977,20179,Sheridan County, Kansas,46.5,2522,72,8,0,8,42,0,42,22,14,8,0,0,0,152,50822,29604,"Sheridan County, Kansas",179,20,6.026962728
978,20181,Sherman County, Kansas,38.1,6038,155,0,0,0,63,51,12,37,17,20,55,47,8,1010,47036,24494,"Sherman County, Kansas",181,20,16.72739318
979,20183,Smith County, Kansas,51.2,3701,12,0,0,0,5,1,4,0,0,0,7,6,1,505,43913,27870,"Smith County, Kansas",183,20,13.64496082
980,20185,Stafford County, Kansas,43,4284,259,4,4,0,121,33,88,93,18,75,41,34,7,654,46830,25046,"Stafford County, Kansas",185,20,15.26610644
981,20187,Stanton County, Kansas,39.2,2115,260,47,0,47,78,5,73,93,27,66,42,37,5,153,44567,22383,"Stanton County, Kansas",187,20,7.234042553
982,20189,Stevens County, Kansas,34.9,5738,959,192,0,192,298,13,285,179,6,173,290,152,138,1014,54333,23579,"Stevens County, Kansas",189,20,17.6716626
983,20191,Sumner County, Kansas,40.5,23509,197,27,14,13,84,23,61,28,21,7,58,49,9,2872,50950,24764,"Sumner County, Kansas",191,20,12.2165979
984,20193,Thomas County, Kansas,36.2,7909,192,69,2,67,41,0,41,65,53,12,17,10,7,756,52074,26241,"Thomas County, Kansas",193,20,9.55873056
985,20195,Trego County, Kansas,50.4,2927,15,1,0,1,0,0,0,3,3,0,11,11,0,123,54630,29651,"Trego County, Kansas",195,20,4.202254868
986,20197,Wabaunsee County, Kansas,43.1,6960,53,11,0,11,5,5,0,22,0,22,15,15,0,459,57791,25194,"Wabaunsee County, Kansas",197,20,6.594827586
987,20199,Wallace County, Kansas,42.5,1584,41,3,0,3,0,0,0,23,0,23,15,11,4,158,45804,28875,"Wallace County, Kansas",199,20,9.974747475
988,20201,Washington County, Kansas,46.3,5613,150,12,0,12,33,0,33,64,0,64,41,37,4,574,47045,24241,"Washington County, Kansas",201,20,10.22626047
989,20203,Wichita County, Kansas,40.5,2168,320,25,0,25,202,9,193,45,19,26,48,21,27,127,57596,26194,"Wichita County, Kansas",203,20,5.857933579
990,20205,Wilson County, Kansas,44,8956,154,2,0,2,29,4,25,20,8,12,103,80,23,1456,43594,23869,"Wilson County, Kansas",205,20,16.2572577
991,20207,Woodson County, Kansas,47.5,3186,27,0,0,0,7,0,7,0,0,0,20,6,14,726,35321,20499,"Woodson County, Kansas",207,20,22.78719397
992,20209,Wyandotte County, Kansas,33.5,161777,25372,3656,58,3598,10816,1298,9518,6522,1336,5186,4378,2232,2146,36409,40757,19282,"Wyandotte County, Kansas",209,20,22.50567139
993,21001,Adair County, Kentucky,40.8,19156,202,47,0,47,41,14,27,54,15,39,60,22,38,4146,33873,18463,"Adair County, Kentucky",1,21,21.64334934
994,21003,Allen County, Kentucky,40.3,20421,208,19,0,19,80,5,75,23,6,17,86,44,42,3420,41166,20607,"Allen County, Kentucky",3,21,16.74746584
995,21005,Anderson County, Kentucky,40.6,21867,220,9,0,9,120,0,120,41,0,41,50,19,31,2453,53513,24891,"Anderson County, Kentucky",5,21,11.2178168
996,21007,Ballard County, Kentucky,42.9,8216,141,8,0,8,17,17,0,51,49,2,65,58,7,1298,43923,24459,"Ballard County, Kentucky",7,21,15.79844206
997,21009,Barren County, Kentucky,40.2,43287,758,140,0,140,234,19,215,187,52,135,197,98,99,9066,39034,20130,"Barren County, Kentucky",9,21,20.94393236
998,21011,Bath County, Kentucky,40.3,12113,127,13,0,13,72,17,55,25,0,25,17,0,17,2931,34986,19590,"Bath County, Kentucky",11,21,24.19714356
999,21013,Bell County, Kentucky,41.1,27676,128,45,0,45,43,14,29,33,33,0,7,7,0,9776,22603,13654,"Bell County, Kentucky",13,21,35.32302356
1000,21015,Boone County, Kentucky,36.6,125656,5501,1000,71,929,1662,467,1195,1687,740,947,1152,906,246,9856,69165,31593,"Boone County, Kentucky",15,21,7.843636595
1001,21017,Bourbon County, Kentucky,41.6,20004,987,98,15,83,574,32,542,183,80,103,132,91,41,3347,44232,24433,"Bourbon County, Kentucky",17,21,16.73165367
1002,21019,Boyd County, Kentucky,41.8,48716,443,63,17,46,112,63,49,63,47,16,205,152,53,8795,44140,25939,"Boyd County, Kentucky",19,21,18.05361688
1003,21021,Boyle County, Kentucky,40.7,29650,605,125,0,125,238,91,147,141,64,77,101,59,42,4381,40758,23276,"Boyle County, Kentucky",21,21,14.77571669
1004,21023,Bracken County, Kentucky,41,8404,74,20,0,20,21,0,21,20,0,20,13,3,10,1718,35887,21569,"Bracken County, Kentucky",23,21,20.44264636
1005,21025,Breathitt County, Kentucky,41,13476,60,4,0,4,17,3,14,8,8,0,31,19,12,4411,25484,15798,"Breathitt County, Kentucky",25,21,32.73226477
1006,21027,Breckinridge County, Kentucky,43.2,20000,103,45,0,45,15,9,6,38,25,13,5,5,0,3350,43390,19984,"Breckinridge County, Kentucky",27,21,16.75
1007,21029,Bullitt County, Kentucky,39.7,77727,679,59,19,40,221,72,149,102,102,0,297,254,43,7904,58702,25805,"Bullitt County, Kentucky",29,21,10.16892457
1008,21031,Butler County, Kentucky,41,12828,145,14,0,14,106,0,106,15,4,11,10,10,0,3080,38427,20591,"Butler County, Kentucky",31,21,24.00997817
1009,21033,Caldwell County, Kentucky,42.4,12758,15,0,0,0,0,0,0,0,0,0,15,15,0,2647,43491,23308,"Caldwell County, Kentucky",33,21,20.74776611
1010,21035,Calloway County, Kentucky,34.1,38302,1987,932,0,932,545,87,458,320,169,151,190,168,22,8615,36692,21109,"Calloway County, Kentucky",35,21,22.49229805
1011,21037,Campbell County, Kentucky,37.9,91456,2104,730,3,727,466,201,265,357,171,186,551,533,18,13138,56772,29834,"Campbell County, Kentucky",37,21,14.36537789
1012,21039,Carlisle County, Kentucky,42.4,4954,42,0,0,0,18,3,15,0,0,0,24,20,4,798,40913,23456,"Carlisle County, Kentucky",39,21,16.1081954
1013,21041,Carroll County, Kentucky,38,10776,347,2,0,2,250,17,233,36,0,36,59,44,15,2698,42882,21639,"Carroll County, Kentucky",41,21,25.03711952
1014,21043,Carter County, Kentucky,40.7,27292,150,103,0,103,30,0,30,17,17,0,0,0,0,4933,37367,19170,"Carter County, Kentucky",43,21,18.07489374
1015,21045,Casey County, Kentucky,42.6,15928,194,27,0,27,114,0,114,32,0,32,21,17,4,4114,32315,18146,"Casey County, Kentucky",45,21,25.82872928
1016,21047,Christian County, Kentucky,28.3,73936,2061,309,13,296,966,357,609,430,322,108,356,306,50,13719,40253,19962,"Christian County, Kentucky",47,21,18.55523696
1017,21049,Clark County, Kentucky,42,35706,589,57,12,45,350,122,228,129,28,101,53,44,9,5300,49069,25674,"Clark County, Kentucky",49,21,14.84344368
1018,21051,Clay County, Kentucky,39,21160,212,8,0,8,29,0,29,74,40,34,101,20,81,7961,22174,14255,"Clay County, Kentucky",51,21,37.62287335
1019,21053,Clinton County, Kentucky,40.9,10172,138,63,0,63,61,0,61,3,0,3,11,11,0,2245,29872,18444,"Clinton County, Kentucky",53,21,22.0703893
1020,21055,Crittenden County, Kentucky,43.3,9211,82,4,0,4,38,3,35,8,8,0,32,14,18,1909,38739,21735,"Crittenden County, Kentucky",55,21,20.72521985
1021,21057,Cumberland County, Kentucky,45.2,6780,51,5,0,5,27,8,19,0,0,0,19,0,19,1484,33268,18362,"Cumberland County, Kentucky",57,21,21.8879056
1022,21059,Daviess County, Kentucky,39.1,98724,2438,1092,24,1068,631,122,509,318,171,147,397,256,141,15599,46675,25026,"Daviess County, Kentucky",59,21,15.80061586
1023,21061,Edmonson County, Kentucky,42.9,12086,75,35,0,35,1,0,1,8,8,0,31,25,6,2606,41689,20194,"Edmonson County, Kentucky",61,21,21.56213801
1024,21063,Elliott County, Kentucky,42.1,7661,4,4,0,4,0,0,0,0,0,0,0,0,0,2210,27969,14218,"Elliott County, Kentucky",63,21,28.84740895
1025,21065,Estill County, Kentucky,42.7,14406,28,0,0,0,0,0,0,16,16,0,12,5,7,4326,29694,16763,"Estill County, Kentucky",65,21,30.02915452
1026,21067,Fayette County, Kentucky,34.1,311529,27760,7349,355,6994,10560,2149,8411,6006,2307,3699,3845,2849,996,56444,50661,30502,"Fayette County, Kentucky",67,21,18.11837742
1027,21069,Fleming County, Kentucky,40.6,14543,52,0,0,0,7,7,0,44,36,8,1,1,0,3226,36063,22222,"Fleming County, Kentucky",69,21,22.1824933
1028,21071,Floyd County, Kentucky,41,38144,146,54,0,54,0,0,0,78,72,6,14,14,0,11532,30540,18345,"Floyd County, Kentucky",71,21,30.23280201
1029,21073,Franklin County, Kentucky,40.8,49982,1674,408,0,408,643,260,383,342,177,165,281,218,63,7054,50999,27252,"Franklin County, Kentucky",73,21,14.11308071
1030,21075,Fulton County, Kentucky,43,6323,50,9,0,9,24,5,19,11,0,11,6,6,0,1566,26841,18067,"Fulton County, Kentucky",75,21,24.76672466
1031,21077,Gallatin County, Kentucky,37.2,8543,290,56,0,56,154,20,134,19,0,19,61,61,0,1131,51180,21452,"Gallatin County, Kentucky",77,21,13.23890905
1032,21079,Garrard County, Kentucky,42.4,17051,239,2,0,2,88,13,75,99,19,80,50,50,0,3259,46373,23796,"Garrard County, Kentucky",79,21,19.11324849
1033,21081,Grant County, Kentucky,36.6,24705,316,6,0,6,167,61,106,123,24,99,20,3,17,4857,44191,19395,"Grant County, Kentucky",81,21,19.65998786
1034,21083,Graves County, Kentucky,40.3,37379,1128,269,0,269,400,107,293,230,77,153,229,150,79,6758,40268,21277,"Graves County, Kentucky",83,21,18.0796704
1035,21085,Grayson County, Kentucky,40,26092,181,47,0,47,69,0,69,42,39,3,23,23,0,6212,36129,20783,"Grayson County, Kentucky",85,21,23.80806377
1036,21087,Green County, Kentucky,44,11123,130,0,0,0,71,9,62,28,15,13,31,17,14,2151,36681,20974,"Green County, Kentucky",87,21,19.33830801
1037,21089,Greenup County, Kentucky,43,36255,286,23,13,10,103,21,82,20,16,4,140,111,29,6268,46771,24446,"Greenup County, Kentucky",89,21,17.28864984
1038,21091,Hancock County, Kentucky,41.4,8716,42,2,0,2,0,0,0,18,0,18,22,8,14,1481,49375,22041,"Hancock County, Kentucky",91,21,16.99173933
1039,21093,Hardin County, Kentucky,36,107573,4387,609,77,532,949,350,599,775,448,327,2054,1699,355,14847,51541,25561,"Hardin County, Kentucky",93,21,13.80179041
1040,21095,Harlan County, Kentucky,41.2,28031,177,20,11,9,81,73,8,48,8,40,28,28,0,8857,25350,16080,"Harlan County, Kentucky",95,21,31.59716029
1041,21097,Harrison County, Kentucky,42.4,18629,320,43,43,0,144,14,130,57,0,57,76,0,76,3476,40164,22024,"Harrison County, Kentucky",97,21,18.65907993
1042,21099,Hart County, Kentucky,40.8,18510,164,55,0,55,65,5,60,0,0,0,44,28,16,4398,35738,19566,"Hart County, Kentucky",99,21,23.76012966
1043,21101,Henderson County, Kentucky,40.2,46362,616,34,0,34,231,95,136,164,53,111,187,147,40,8696,41630,23752,"Henderson County, Kentucky",101,21,18.75674043
1044,21103,Henry County, Kentucky,41.5,15528,196,5,5,0,64,0,64,59,27,32,68,68,0,2661,50412,22499,"Henry County, Kentucky",103,21,17.13678516
1045,21105,Hickman County, Kentucky,47.3,4691,38,0,0,0,5,3,2,20,20,0,13,13,0,753,39756,18416,"Hickman County, Kentucky",105,21,16.0520145
1046,21107,Hopkins County, Kentucky,41,46359,469,101,30,71,160,34,126,60,37,23,148,123,25,7280,43169,22672,"Hopkins County, Kentucky",107,21,15.70353114
1047,21109,Jackson County, Kentucky,40.6,13357,64,0,0,0,0,0,0,0,0,0,64,64,0,4381,30884,16713,"Jackson County, Kentucky",109,21,32.79928128
1048,21111,Jefferson County, Kentucky,38,759724,52457,11751,532,11219,22241,7590,14651,10481,6597,3884,7984,6327,1657,119158,50099,29758,"Jefferson County, Kentucky",111,21,15.68438012
1049,21113,Jessamine County, Kentucky,37.6,51015,2281,451,16,435,790,309,481,651,423,228,389,239,150,9139,52748,27409,"Jessamine County, Kentucky",113,21,17.91433892
1050,21115,Johnson County, Kentucky,41.6,23280,134,2,0,2,89,10,79,0,0,0,43,16,27,5964,35060,18290,"Johnson County, Kentucky",115,21,25.6185567
1051,21117,Kenton County, Kentucky,36.7,163393,4429,631,31,600,1765,616,1149,1149,561,588,884,631,253,21805,56568,28785,"Kenton County, Kentucky",117,21,13.34512494
1052,21119,Knott County, Kentucky,41.3,15884,53,32,0,32,8,3,5,9,1,8,4,2,2,4784,28165,17761,"Knott County, Kentucky",119,21,30.1183581
1053,21121,Knox County, Kentucky,40.1,31740,445,185,0,185,110,92,18,54,54,0,96,76,20,10613,26553,15479,"Knox County, Kentucky",121,21,33.43730309
1054,21123,Larue County, Kentucky,40.8,14127,285,13,0,13,95,0,95,69,0,69,108,80,28,2260,41050,21204,"Larue County, Kentucky",123,21,15.99773483
1055,21125,Laurel County, Kentucky,39.1,59950,569,39,0,39,234,105,129,70,35,35,226,217,9,13475,36139,19383,"Laurel County, Kentucky",125,21,22.47706422
1056,21127,Lawrence County, Kentucky,41.1,15870,177,83,0,83,32,20,12,25,12,13,37,37,0,3519,35016,18410,"Lawrence County, Kentucky",127,21,22.17391304
1057,21129,Lee County, Kentucky,42.8,6896,13,0,0,0,6,0,6,0,0,0,7,7,0,2360,21185,13873,"Lee County, Kentucky",129,21,34.22273782
1058,21131,Leslie County, Kentucky,41.7,10869,37,12,0,12,0,0,0,0,0,0,25,25,0,3435,25282,14653,"Leslie County, Kentucky",131,21,31.60364339
1059,21133,Letcher County, Kentucky,41.7,23382,81,5,0,5,32,4,28,9,0,9,35,20,15,6889,29181,17181,"Letcher County, Kentucky",133,21,29.46283466
1060,21135,Lewis County, Kentucky,40.9,13646,42,0,0,0,39,23,16,0,0,0,3,0,3,3773,29088,17753,"Lewis County, Kentucky",135,21,27.64912795
1061,21137,Lincoln County, Kentucky,40.5,24424,96,0,0,0,9,9,0,47,7,40,40,26,14,6049,35185,18720,"Lincoln County, Kentucky",137,21,24.76662299
1062,21139,Livingston County, Kentucky,46.5,9353,37,0,0,0,7,7,0,0,0,0,30,30,0,1282,43333,24203,"Livingston County, Kentucky",139,21,13.70683203
1063,21141,Logan County, Kentucky,40.6,26757,258,0,0,0,87,57,30,116,53,63,55,46,9,4778,39027,20385,"Logan County, Kentucky",141,21,17.85700938
1064,21143,Lyon County, Kentucky,49,8325,142,5,0,5,54,20,34,69,0,69,14,12,2,1030,47861,26105,"Lyon County, Kentucky",143,21,12.37237237
1065,21145,McCracken County, Kentucky,42.4,65292,1529,193,65,128,611,336,275,306,115,191,419,374,45,11342,42303,28926,"McCracken County, Kentucky",145,21,17.37119402
1066,21147,McCreary County, Kentucky,38.9,17850,71,41,0,41,4,0,4,0,0,0,26,18,8,6906,18972,11114,"McCreary County, Kentucky",147,21,38.68907563
1067,21149,McLean County, Kentucky,41.4,9492,90,10,0,10,18,3,15,46,33,13,16,2,14,1718,43005,21623,"McLean County, Kentucky",149,21,18.09945217
1068,21151,Madison County, Kentucky,33.9,87324,2096,736,59,677,830,317,513,334,184,150,196,153,43,17222,43707,22271,"Madison County, Kentucky",151,21,19.72195502
1069,21153,Magoffin County, Kentucky,41.2,12887,64,17,0,17,17,0,17,0,0,0,30,17,13,3751,29463,15710,"Magoffin County, Kentucky",153,21,29.10685187
1070,21155,Marion County, Kentucky,39.1,19497,335,42,16,26,165,51,114,90,20,70,38,34,4,3541,40392,20450,"Marion County, Kentucky",155,21,18.16176848
1071,21157,Marshall County, Kentucky,44.8,31213,303,69,0,69,34,16,18,72,15,57,128,106,22,3201,45670,25138,"Marshall County, Kentucky",157,21,10.25534233
1072,21159,Martin County, Kentucky,38.1,12478,59,0,0,0,5,5,0,0,0,0,54,19,35,3538,29052,14938,"Martin County, Kentucky",159,21,28.35390287
1073,21161,Mason County, Kentucky,40.9,17229,307,191,0,191,9,0,9,35,17,18,72,50,22,3446,38613,24124,"Mason County, Kentucky",161,21,20.00116083
1074,21163,Meade County, Kentucky,37.1,28751,445,79,9,70,192,71,121,75,58,17,99,99,0,4426,50034,24018,"Meade County, Kentucky",163,21,15.39424716
1075,21165,Menifee County, Kentucky,44.1,6345,47,0,0,0,13,0,13,34,0,34,0,0,0,1495,35280,18995,"Menifee County, Kentucky",165,21,23.56185973
1076,21167,Mercer County, Kentucky,43,21411,457,89,0,89,113,14,99,96,77,19,159,101,58,3846,46130,24079,"Mercer County, Kentucky",167,21,17.96272944
1077,21169,Metcalfe County, Kentucky,43.5,9983,99,3,0,3,48,44,4,9,9,0,39,39,0,2250,33788,18141,"Metcalfe County, Kentucky",169,21,22.53831514
1078,21171,Monroe County, Kentucky,42.7,10692,215,16,0,16,142,14,128,47,11,36,10,10,0,2749,34120,19969,"Monroe County, Kentucky",171,21,25.71081182
1079,21173,Montgomery County, Kentucky,38.9,27391,261,18,0,18,204,22,182,28,6,22,11,2,9,6777,39750,20437,"Montgomery County, Kentucky",173,21,24.74170348
1080,21175,Morgan County, Kentucky,41.2,13379,105,24,0,24,33,7,26,21,13,8,27,27,0,2889,32517,16780,"Morgan County, Kentucky",175,21,21.59354212
1081,21177,Muhlenberg County, Kentucky,41.5,31216,172,0,0,0,37,3,34,71,70,1,64,57,7,5914,40445,19934,"Muhlenberg County, Kentucky",177,21,18.94541261
1082,21179,Nelson County, Kentucky,38,44875,496,27,0,27,165,15,150,112,0,112,192,158,34,6185,51408,26353,"Nelson County, Kentucky",179,21,13.78272981
1083,21181,Nicholas County, Kentucky,42,7062,92,8,0,8,0,0,0,53,0,53,31,26,5,1804,37993,22438,"Nicholas County, Kentucky",181,21,25.54517134
1084,21183,Ohio County, Kentucky,40.6,24152,539,82,0,82,249,225,24,73,0,73,135,135,0,5003,39479,19963,"Ohio County, Kentucky",183,21,20.71464061
1085,21185,Oldham County, Kentucky,39.1,63876,1952,226,65,161,748,268,480,502,348,154,476,402,74,3566,86324,35795,"Oldham County, Kentucky",185,21,5.582691465
1086,21187,Owen County, Kentucky,41.6,10673,29,0,0,0,0,0,0,29,29,0,0,0,0,1858,41597,22151,"Owen County, Kentucky",187,21,17.40841375
1087,21189,Owsley County, Kentucky,41.7,4552,12,0,0,0,12,0,12,0,0,0,0,0,0,1652,22106,16533,"Owsley County, Kentucky",189,21,36.29173989
1088,21191,Pendleton County, Kentucky,41.7,14509,44,18,0,18,23,15,8,0,0,0,3,3,0,2126,49766,23578,"Pendleton County, Kentucky",191,21,14.65297402
1089,21193,Perry County, Kentucky,41.1,27818,370,0,0,0,198,136,62,113,98,15,59,59,0,7394,31578,19697,"Perry County, Kentucky",193,21,26.57991229
1090,21195,Pike County, Kentucky,41.5,62791,502,105,17,88,123,63,60,112,96,16,162,126,36,15528,32816,20128,"Pike County, Kentucky",195,21,24.72965871
1091,21197,Powell County, Kentucky,38.7,12387,140,21,0,21,76,33,43,23,18,5,20,8,12,3115,34048,18158,"Powell County, Kentucky",197,21,25.14733188
1092,21199,Pulaski County, Kentucky,41.8,63772,1201,323,101,222,474,121,353,260,218,42,144,133,11,15643,34673,21083,"Pulaski County, Kentucky",199,21,24.52957411
1093,21201,Robertson County, Kentucky,47.7,2191,2,0,0,0,0,0,0,2,2,0,0,0,0,520,30964,22702,"Robertson County, Kentucky",201,21,23.73345504
1094,21203,Rockcastle County, Kentucky,42.3,16893,33,0,0,0,19,13,6,8,0,8,6,6,0,3875,33500,17930,"Rockcastle County, Kentucky",203,21,22.93849523
1095,21205,Rowan County, Kentucky,31,24302,750,197,0,197,313,73,240,71,37,34,169,156,13,5510,36216,18743,"Rowan County, Kentucky",205,21,22.67303103
1096,21207,Russell County, Kentucky,43.4,17684,400,66,66,0,239,19,220,22,0,22,73,58,15,4606,31539,17702,"Russell County, Kentucky",207,21,26.04614341
1097,21209,Scott County, Kentucky,36.1,51348,1742,240,6,234,849,164,685,370,178,192,283,223,60,5309,64329,29345,"Scott County, Kentucky",209,21,10.33925372
1098,21211,Shelby County, Kentucky,38.5,44967,2971,619,0,619,1420,149,1271,655,145,510,277,195,82,5600,61737,28502,"Shelby County, Kentucky",211,21,12.45357707
1099,21213,Simpson County, Kentucky,40.1,17856,299,51,0,51,168,44,124,27,0,27,53,46,7,3317,42288,21122,"Simpson County, Kentucky",213,21,18.57638889
1100,21215,Spencer County, Kentucky,40.6,17798,216,0,0,0,55,45,10,26,26,0,135,127,8,1782,65700,27227,"Spencer County, Kentucky",215,21,10.01236094
1101,21217,Taylor County, Kentucky,38.6,25315,383,213,0,213,84,13,71,38,19,19,48,38,10,6090,32977,18613,"Taylor County, Kentucky",217,21,24.05688327
1102,21219,Todd County, Kentucky,37.2,12465,292,32,0,32,189,115,74,15,1,14,56,49,7,2107,41306,19165,"Todd County, Kentucky",219,21,16.90332932
1103,21221,Trigg County, Kentucky,45.1,14267,125,17,0,17,0,0,0,36,26,10,72,72,0,2262,45032,26068,"Trigg County, Kentucky",221,21,15.85476975
1104,21223,Trimble County, Kentucky,40.9,8751,46,0,0,0,1,0,1,3,0,3,42,22,20,1539,45935,24515,"Trimble County, Kentucky",223,21,17.58656154
1105,21225,Union County, Kentucky,37.7,15065,169,51,0,51,44,5,39,18,12,6,56,41,15,3528,41255,21063,"Union County, Kentucky",225,21,23.41851975
1106,21227,Warren County, Kentucky,32.9,121066,11205,3269,104,3165,3935,1125,2810,2785,1559,1226,1216,802,414,21838,46929,24060,"Warren County, Kentucky",227,21,18.03809492
1107,21229,Washington County, Kentucky,41,12017,275,60,0,60,141,0,141,46,31,15,28,10,18,2060,43719,20834,"Washington County, Kentucky",229,21,17.14238163
1108,21231,Wayne County, Kentucky,42.1,20557,263,0,0,0,95,4,91,168,64,104,0,0,0,5138,30260,16104,"Wayne County, Kentucky",231,21,24.99391935
1109,21233,Webster County, Kentucky,39.8,13331,372,42,0,42,162,45,117,83,20,63,85,37,48,2615,38374,20117,"Webster County, Kentucky",233,21,19.61593279
1110,21235,Whitley County, Kentucky,36.7,35842,192,75,0,75,46,34,12,13,0,13,58,16,42,9191,32397,17520,"Whitley County, Kentucky",235,21,25.64310027
1111,21237,Wolfe County, Kentucky,41.8,7221,0,0,0,0,0,0,0,0,0,0,0,0,0,2896,21797,14274,"Wolfe County, Kentucky",237,21,40.10524858
1112,21239,Woodford County, Kentucky,41.9,25591,1217,178,4,174,588,63,525,303,46,257,148,104,44,3636,59471,30786,"Woodford County, Kentucky",239,21,14.20812004
1113,22001,Acadia Parish, Louisiana,35.8,62372,911,266,0,266,395,139,256,125,40,85,125,103,22,12579,39837,20887,"Acadia Parish, Louisiana",1,22,20.16770346
1114,22003,Allen Parish, Louisiana,38.6,25619,858,84,0,84,260,10,250,218,45,173,296,65,231,3367,41801,20296,"Allen Parish, Louisiana",3,22,13.14258948
1115,22005,Ascension Parish, Louisiana,35,117009,3014,487,0,487,920,156,764,817,375,442,790,611,179,13320,71752,30094,"Ascension Parish, Louisiana",5,22,11.38373971
1116,22007,Assumption Parish, Louisiana,39.3,22973,302,67,0,67,108,10,98,55,19,36,72,44,28,4186,47822,24207,"Assumption Parish, Louisiana",7,22,18.22139033
1117,22009,Avoyelles Parish, Louisiana,38.1,41252,368,166,7,159,134,68,66,4,4,0,64,64,0,8671,34985,19595,"Avoyelles Parish, Louisiana",9,22,21.01958693
1118,22011,Beauregard Parish, Louisiana,37.4,36435,1009,191,0,191,386,124,262,62,47,15,370,282,88,6815,46599,23141,"Beauregard Parish, Louisiana",11,22,18.70454234
1119,22013,Bienville Parish, Louisiana,42.3,13924,52,20,19,1,3,0,3,0,0,0,29,22,7,3406,35722,22123,"Bienville Parish, Louisiana",13,22,24.46136168
1120,22015,Bossier Parish, Louisiana,34.7,124720,5563,1059,107,952,1736,351,1385,922,335,587,1846,1550,296,18867,51894,27210,"Bossier Parish, Louisiana",15,22,15.12748557
1121,22017,Caddo Parish, Louisiana,36.8,253125,5763,1004,99,905,1662,438,1224,1306,678,628,1791,1438,353,55675,40815,25206,"Caddo Parish, Louisiana",17,22,21.99506173
1122,22019,Calcasieu Parish, Louisiana,36.1,197233,4779,1150,82,1068,1432,502,930,812,413,399,1385,1001,384,33266,46457,25249,"Calcasieu Parish, Louisiana",19,22,16.8663459
1123,22021,Caldwell Parish, Louisiana,39.7,9997,174,89,0,89,32,0,32,40,7,33,13,12,1,2391,29832,19774,"Caldwell Parish, Louisiana",21,22,23.91717515
1124,22023,Cameron Parish, Louisiana,40.9,6739,228,2,0,2,7,0,7,49,0,49,170,170,0,601,65679,31007,"Cameron Parish, Louisiana",23,22,8.918237127
1125,22025,Catahoula Parish, Louisiana,38.2,10145,148,93,93,0,14,0,14,7,0,7,34,12,22,1875,34736,21870,"Catahoula Parish, Louisiana",25,22,18.48201084
1126,22027,Claiborne Parish, Louisiana,41.3,16452,121,4,0,4,36,0,36,0,0,0,81,35,46,4367,28927,16417,"Claiborne Parish, Louisiana",27,22,26.54388524
1127,22029,Concordia Parish, Louisiana,37.4,20288,102,7,0,7,23,11,12,35,16,19,37,37,0,5794,28405,17110,"Concordia Parish, Louisiana",29,22,28.55875394
1128,22031,De Soto Parish, Louisiana,39.6,27047,300,8,0,8,148,50,98,32,28,4,112,82,30,7097,42368,23284,"De Soto Parish, Louisiana",31,22,26.239509
1129,22033,East Baton Rouge Parish, Louisiana,33.3,445337,23021,5148,323,4825,7391,1587,5804,4784,2662,2122,5698,5083,615,85171,49942,29146,"East Baton Rouge Parish, Louisiana",33,22,19.12506708
1130,22035,East Carroll Parish, Louisiana,31.7,7419,56,0,0,0,40,6,34,10,0,10,6,3,3,2671,22093,11133,"East Carroll Parish, Louisiana",35,22,36.00215662
1131,22037,East Feliciana Parish, Louisiana,41.9,19756,154,0,0,0,43,0,43,34,17,17,77,77,0,2885,48997,21850,"East Feliciana Parish, Louisiana",37,22,14.60315853
1132,22039,Evangeline Parish, Louisiana,35.5,33765,1022,466,0,466,325,94,231,156,0,156,75,30,45,8807,30724,18440,"Evangeline Parish, Louisiana",39,22,26.08322227
1133,22041,Franklin Parish, Louisiana,38,20464,42,17,8,9,20,0,20,0,0,0,5,5,0,6017,32440,18178,"Franklin Parish, Louisiana",41,22,29.40285379
1134,22043,Grant Parish, Louisiana,37.5,22372,723,100,6,94,116,28,88,306,19,287,201,51,150,3590,40389,18376,"Grant Parish, Louisiana",43,22,16.04684427
1135,22045,Iberia Parish, Louisiana,35.9,73799,2881,679,61,618,954,210,744,362,174,188,886,487,399,14437,44573,23737,"Iberia Parish, Louisiana",45,22,19.5625957
1136,22047,Iberville Parish, Louisiana,38.4,33159,211,22,0,22,32,5,27,78,11,67,79,65,14,5465,46480,22397,"Iberville Parish, Louisiana",47,22,16.48119666
1137,22049,Jackson Parish, Louisiana,39.5,15999,208,23,0,23,111,4,107,41,21,20,33,33,0,4035,38310,19293,"Jackson Parish, Louisiana",49,22,25.22032627
1138,22051,Jefferson Parish, Louisiana,38.8,435204,53837,8338,733,7605,18266,3363,14903,10289,5038,5251,16944,13516,3428,69402,49457,28067,"Jefferson Parish, Louisiana",51,22,15.94700416
1139,22053,Jefferson Davis Parish, Louisiana,38,31399,264,50,0,50,10,0,10,8,1,7,196,153,43,6020,39202,22665,"Jefferson Davis Parish, Louisiana",53,22,19.17258511
1140,22055,Lafayette Parish, Louisiana,34.2,234963,9865,2265,255,2010,4003,909,3094,1608,841,767,1989,1513,476,37976,52435,30403,"Lafayette Parish, Louisiana",55,22,16.16254474
1141,22057,Lafourche Parish, Louisiana,36.7,97688,3144,677,24,653,1351,213,1138,444,240,204,672,466,206,14646,52071,25299,"Lafourche Parish, Louisiana",57,22,14.9926296
1142,22059,LaSalle Parish, Louisiana,38.7,14927,350,107,0,107,132,2,130,99,7,92,12,4,8,3134,35339,19434,"LaSalle Parish, Louisiana",59,22,20.99551149
1143,22061,Lincoln Parish, Louisiana,27.4,47480,1876,902,7,895,407,18,389,234,115,119,333,282,51,13916,34527,21452,"Lincoln Parish, Louisiana",61,22,29.30918281
1144,22063,Livingston Parish, Louisiana,35.6,135925,2982,387,93,294,848,208,640,736,255,481,1011,954,57,19472,57334,26558,"Livingston Parish, Louisiana",63,22,14.32554718
1145,22065,Madison Parish, Louisiana,34.2,11803,53,0,0,0,53,47,6,0,0,0,0,0,0,3973,25404,14564,"Madison Parish, Louisiana",65,22,33.66093366
1146,22067,Morehouse Parish, Louisiana,39.6,26739,177,52,0,52,48,0,48,39,4,35,38,38,0,7441,30279,18222,"Morehouse Parish, Louisiana",67,22,27.82826583
1147,22069,Natchitoches Parish, Louisiana,33.6,39258,612,161,74,87,236,123,113,82,48,34,133,125,8,11401,30697,19178,"Natchitoches Parish, Louisiana",69,22,29.04121453
1148,22071,Orleans Parish, Louisiana,35.5,382922,22552,4843,286,4557,6391,1542,4849,3712,1986,1726,7606,5994,1612,97252,37488,28444,"Orleans Parish, Louisiana",71,22,25.39733941
1149,22073,Ouachita Parish, Louisiana,34.9,156398,2548,787,0,787,639,200,439,340,239,101,782,634,148,35652,38974,21866,"Ouachita Parish, Louisiana",73,22,22.79568792
1150,22075,Plaquemines Parish, Louisiana,36.3,23584,1398,171,15,156,436,58,378,189,95,94,602,389,213,3990,50251,25359,"Plaquemines Parish, Louisiana",75,22,16.91824966
1151,22077,Pointe Coupee Parish, Louisiana,42.7,22366,305,44,0,44,150,34,116,42,0,42,69,69,0,4182,44275,25670,"Pointe Coupee Parish, Louisiana",77,22,18.69802379
1152,22079,Rapides Parish, Louisiana,37.3,132373,3883,625,36,589,1146,250,896,955,529,426,1157,946,211,25882,42132,22904,"Rapides Parish, Louisiana",79,22,19.55232563
1153,22081,Red River Parish, Louisiana,40,8757,68,45,0,45,17,17,0,6,6,0,0,0,0,1953,36831,23748,"Red River Parish, Louisiana",81,22,22.30215827
1154,22083,Richland Parish, Louisiana,37.8,20692,56,0,0,0,9,6,3,0,0,0,47,34,13,4751,35684,19347,"Richland Parish, Louisiana",83,22,22.96056447
1155,22085,Sabine Parish, Louisiana,40.8,24144,353,81,12,69,114,5,109,72,33,39,86,80,6,4612,39372,22725,"Sabine Parish, Louisiana",85,22,19.10205434
1156,22087,St. Bernard Parish, Louisiana,33.2,44091,2392,490,50,440,860,302,558,389,292,97,653,546,107,8784,43565,19990,"St. Bernard Parish, Louisiana",87,22,19.92243315
1157,22089,St. Charles Parish, Louisiana,37.4,52708,2124,368,62,306,667,164,503,503,212,291,586,415,171,6522,61691,28146,"St. Charles Parish, Louisiana",89,22,12.37383319
1158,22091,St. Helena Parish, Louisiana,38.5,10714,94,46,0,46,7,0,7,0,0,0,41,41,0,2895,36418,19134,"St. Helena Parish, Louisiana",91,22,27.02072055
1159,22093,St. James Parish, Louisiana,38.8,21581,136,12,0,12,28,28,0,14,0,14,82,27,55,3496,51386,25275,"St. James Parish, Louisiana",93,22,16.19943469
1160,22095,St. John the Baptist Parish, Louisiana,36.3,43888,1412,356,0,356,358,86,272,215,114,101,483,403,80,7851,51406,22775,"St. John the Baptist Parish, Louisiana",95,22,17.88871673
1161,22097,St. Landry Parish, Louisiana,36.4,83699,895,64,0,64,368,0,368,245,109,136,218,158,60,23007,31424,19008,"St. Landry Parish, Louisiana",97,22,27.48778361
1162,22099,St. Martin Parish, Louisiana,36.9,53385,1092,417,0,417,302,68,234,106,72,34,267,198,69,9103,46450,23597,"St. Martin Parish, Louisiana",99,22,17.05160626
1163,22101,St. Mary Parish, Louisiana,38.1,53053,2150,250,0,250,947,35,912,432,110,322,521,388,133,11227,40771,21989,"St. Mary Parish, Louisiana",101,22,21.16185701
1164,22103,St. Tammany Parish, Louisiana,39.8,246269,8585,1261,81,1180,2392,764,1628,1707,1102,605,3225,2609,616,27094,63686,31792,"St. Tammany Parish, Louisiana",103,22,11.00179072
1165,22105,Tangipahoa Parish, Louisiana,34.7,127115,2430,744,4,740,700,156,544,263,89,174,723,517,206,27460,43690,22554,"Tangipahoa Parish, Louisiana",105,22,21.60248594
1166,22107,Tensas Parish, Louisiana,42.6,4793,9,0,0,0,0,0,0,0,0,0,9,4,5,1615,22385,16171,"Tensas Parish, Louisiana",107,22,33.69497183
1167,22109,Terrebonne Parish, Louisiana,35.4,113099,4215,777,39,738,1547,402,1145,945,593,352,946,704,242,22457,48166,24069,"Terrebonne Parish, Louisiana",109,22,19.85605531
1168,22111,Union Parish, Louisiana,41.4,22460,444,135,0,135,87,21,66,71,17,54,151,66,85,5438,37049,20090,"Union Parish, Louisiana",111,22,24.21193232
1169,22113,Vermilion Parish, Louisiana,36.9,59524,1542,330,38,292,382,73,309,344,218,126,486,325,161,10150,47083,23521,"Vermilion Parish, Louisiana",113,22,17.05194543
1170,22115,Vernon Parish, Louisiana,30.1,52101,2068,395,114,281,636,349,287,346,279,67,691,582,109,7286,46561,22297,"Vernon Parish, Louisiana",115,22,13.9843765
1171,22117,Washington Parish, Louisiana,39.4,46367,727,71,0,71,343,39,304,136,24,112,177,120,57,11756,31013,17957,"Washington Parish, Louisiana",117,22,25.35423901
1172,22119,Webster Parish, Louisiana,40.7,40335,308,67,6,61,6,6,0,53,44,9,182,150,32,9693,31920,19512,"Webster Parish, Louisiana",119,22,24.03123838
1173,22121,West Baton Rouge Parish, Louisiana,35.5,25017,343,13,0,13,180,13,167,109,20,89,41,22,19,4933,53882,27245,"West Baton Rouge Parish, Louisiana",121,22,19.71859136
1174,22123,West Carroll Parish, Louisiana,39.9,11370,112,39,26,13,23,8,15,5,5,0,45,3,42,2551,36670,21459,"West Carroll Parish, Louisiana",123,22,22.43623571
1175,22125,West Feliciana Parish, Louisiana,39.6,15384,89,8,0,8,13,0,13,20,10,10,48,29,19,1923,53364,22335,"West Feliciana Parish, Louisiana",125,22,12.5
1176,22127,Winn Parish, Louisiana,40.9,14695,80,0,0,0,39,0,39,41,34,7,0,0,0,3319,32063,18358,"Winn Parish, Louisiana",127,22,22.58591358
1177,23001,Androscoggin County, Maine,40.7,107376,3207,678,93,585,879,492,387,424,263,161,1226,857,369,15370,48728,25788,"Androscoggin County, Maine",1,23,14.31418567
1178,23003,Aroostook County, Maine,46.9,69405,3023,260,8,252,306,103,203,276,163,113,2181,1629,552,11929,38087,22483,"Aroostook County, Maine",3,23,17.18752251
1179,23005,Cumberland County, Maine,42.1,288204,18150,3793,355,3438,5455,2464,2991,4098,2975,1123,4804,4069,735,31192,61902,35066,"Cumberland County, Maine",5,23,10.82288934
1180,23007,Franklin County, Maine,45.3,30270,684,114,5,109,86,44,42,95,91,4,389,273,116,4089,43007,23596,"Franklin County, Maine",7,23,13.50842418
1181,23009,Hancock County, Maine,47.9,54483,1758,251,10,241,544,84,460,241,111,130,722,554,168,6420,50037,30042,"Hancock County, Maine",9,23,11.7834921
1182,23011,Kennebec County, Maine,44,120953,2916,612,0,612,495,206,289,357,266,91,1452,1043,409,17110,48570,26418,"Kennebec County, Maine",11,23,14.14599059
1183,23013,Knox County, Maine,47.5,39717,1105,219,0,219,348,111,237,158,141,17,380,237,143,4577,52239,28413,"Knox County, Maine",13,23,11.52403253
1184,23015,Lincoln County, Maine,50.1,34165,1090,92,12,80,395,137,258,139,88,51,464,344,120,4050,53515,30022,"Lincoln County, Maine",15,23,11.85423679
1185,23017,Oxford County, Maine,46,57299,1069,172,5,167,220,87,133,70,40,30,607,334,273,9447,42197,21674,"Oxford County, Maine",17,23,16.48719873
1186,23019,Penobscot County, Maine,41.6,152978,4146,539,20,519,1194,389,805,572,258,314,1841,1334,507,23793,45302,25035,"Penobscot County, Maine",19,23,15.5532168
1187,23021,Piscataquis County, Maine,50,17044,292,13,0,13,26,14,12,43,18,25,210,142,68,3448,36938,22398,"Piscataquis County, Maine",21,23,20.22999296
1188,23023,Sagadahoc County, Maine,45.8,35134,891,14,0,14,209,164,45,129,65,64,539,429,110,3718,55766,31085,"Sagadahoc County, Maine",23,23,10.58234189
1189,23025,Somerset County, Maine,45.4,51363,889,107,5,102,112,24,88,108,58,50,562,390,172,9118,40484,21961,"Somerset County, Maine",25,23,17.75207834
1190,23027,Waldo County, Maine,45.4,39071,1009,174,3,171,367,160,207,85,42,43,383,253,130,6097,45480,25270,"Waldo County, Maine",27,23,15.60492437
1191,23029,Washington County, Maine,47.3,31925,1269,151,38,113,174,110,64,114,72,42,830,502,328,5561,39469,23113,"Washington County, Maine",29,23,17.41895067
1192,23031,York County, Maine,44.4,200536,6153,1170,205,965,929,731,198,942,602,340,3112,2389,723,18486,59132,31574,"York County, Maine",31,23,9.218294969
1193,24001,Allegany County, Maryland,41.6,73060,1650,413,16,397,510,102,408,292,169,123,435,327,108,11430,41559,22029,"Allegany County, Maryland",1,24,15.64467561
1194,24003,Anne Arundel County, Maryland,38.3,559737,46293,5174,340,4834,15253,4674,10579,10718,6376,4342,15148,12470,2678,33168,91918,42382,"Anne Arundel County, Maryland",3,24,5.925640077
1195,24005,Baltimore County, Maryland,39.1,825666,98129,15320,892,14428,37885,14255,23630,21617,15758,5859,23307,19629,3678,74876,68989,35777,"Baltimore County, Maryland",5,24,9.068557988
1196,24009,Calvert County, Maryland,40.7,90527,2696,408,143,265,450,236,214,403,247,156,1435,1219,216,5400,96808,39897,"Calvert County, Maryland",9,24,5.965071194
1197,24011,Caroline County, Maryland,40,32653,1303,329,21,308,462,35,427,306,50,256,206,107,99,5484,50830,24311,"Caroline County, Maryland",11,24,16.79478149
1198,24013,Carroll County, Maryland,42.4,167535,6054,447,23,424,1896,784,1112,1405,985,420,2306,1842,464,9383,87060,38408,"Carroll County, Maryland",13,24,5.600620766
1199,24015,Cecil County, Maryland,40.2,102175,3336,554,148,406,865,273,592,857,478,379,1060,852,208,10729,67938,30676,"Cecil County, Maryland",15,24,10.5006117
1200,24017,Charles County, Maryland,37.9,154357,9266,1055,73,982,2865,1100,1765,1852,1029,823,3494,2821,673,11637,91373,37680,"Charles County, Maryland",17,24,7.539016695
1201,24019,Dorchester County, Maryland,44.2,32451,1287,74,0,74,686,118,568,163,64,99,364,304,60,5435,47907,28055,"Dorchester County, Maryland",19,24,16.74832825
1202,24021,Frederick County, Maryland,39.2,243465,24094,3783,198,3585,7984,3011,4973,6789,4294,2495,5538,4557,981,16995,85715,38280,"Frederick County, Maryland",21,24,6.980469472
1203,24023,Garrett County, Maryland,44.8,29677,380,72,49,23,41,25,16,24,21,3,243,207,36,3666,46277,25096,"Garrett County, Maryland",23,24,12.35300064
1204,24025,Harford County, Maryland,40.3,249776,13567,1337,112,1225,3511,1810,1701,3107,2127,980,5612,4778,834,19012,81052,36411,"Harford County, Maryland",25,24,7.611620012
1205,24027,Howard County, Maryland,38.7,308447,61263,6989,528,6461,21275,7780,13495,14795,10547,4248,18204,16485,1719,15109,113800,49667,"Howard County, Maryland",27,24,4.898410424
1206,24029,Kent County, Maryland,46.5,19819,859,129,0,129,445,16,429,60,31,29,225,146,79,2193,55028,30080,"Kent County, Maryland",29,24,11.06513951
1207,24031,Montgomery County, Maryland,38.6,1026371,334697,45260,2974,42286,107469,35203,72266,79495,51039,28456,102473,86050,16423,69889,100352,49906,"Montgomery County, Maryland",31,24,6.809331129
1208,24033,Prince George's County, Maryland,36.1,897693,192055,27058,1937,25121,72383,18331,54052,44338,22417,21921,48276,35807,12469,84744,75925,33220,"Prince George's County, Maryland",33,24,9.440198375
1209,24035,Queen Anne's County, Maryland,43.8,48712,1890,210,22,188,565,203,362,288,208,80,827,740,87,3139,85891,39593,"Queen Anne's County, Maryland",35,24,6.443997372
1210,24037,St. Mary's County, Maryland,36.3,110675,4820,740,0,740,1024,497,527,1408,1177,231,1648,1366,282,8440,86810,36814,"St. Mary's County, Maryland",37,24,7.625931782
1211,24039,Somerset County, Maryland,37,25899,1320,281,36,245,344,160,184,271,93,178,424,274,150,4826,35886,17143,"Somerset County, Maryland",39,24,18.63392409
1212,24041,Talbot County, Maryland,49.4,37668,2220,116,0,116,681,217,464,589,209,380,834,667,167,4064,61395,40533,"Talbot County, Maryland",41,24,10.78899862
1213,24043,Washington County, Maryland,40.7,149571,7806,1039,65,974,2636,1105,1531,1873,1204,669,2258,1889,369,18166,56316,27586,"Washington County, Maryland",43,24,12.14540252
1214,24045,Wicomico County, Maryland,35.7,101527,8476,1728,110,1618,3838,1034,2804,1552,939,613,1358,1086,272,15924,53508,26498,"Wicomico County, Maryland",45,24,15.68449772
1215,24047,Worcester County, Maryland,49.4,51441,2363,169,0,169,681,149,532,479,254,225,1034,822,212,5162,57227,32988,"Worcester County, Maryland",47,24,10.03479715
1216,24510,Baltimore city, Maryland,34.7,621000,48508,10666,352,10314,16888,3986,12902,9232,5356,3876,11722,8915,2807,137964,44262,27129,"Baltimore city, Maryland",510,24,22.21642512
1217,25001,Barnstable County, Massachusetts,51.8,214703,14919,1816,163,1653,4582,1809,2773,2838,1847,991,5683,4804,879,17433,65382,39104,"Barnstable County, Massachusetts",1,25,8.119588455
1218,25003,Berkshire County, Massachusetts,46.1,128563,7396,1231,83,1148,2067,717,1350,1129,785,344,2969,2416,553,15136,52253,31417,"Berkshire County, Massachusetts",3,25,11.77321624
1219,25005,Bristol County, Massachusetts,40.7,554868,68073,5079,713,4366,12098,4033,8065,9960,5867,4093,40936,32696,8240,67338,59343,30525,"Bristol County, Massachusetts",5,25,12.13585934
1220,25007,Dukes County, Massachusetts,46.5,17137,1598,36,0,36,484,242,242,562,233,329,516,291,225,1544,63534,40051,"Dukes County, Massachusetts",7,25,9.009744996
1221,25009,Essex County, Massachusetts,40.7,769362,121786,17734,1529,16205,37238,14543,22695,27361,17728,9633,39453,31408,8045,84757,70886,37210,"Essex County, Massachusetts",9,25,11.01653058
1222,25011,Franklin County, Massachusetts,45.4,70916,3689,897,4,893,1132,501,631,656,533,123,1004,744,260,7881,56347,31689,"Franklin County, Massachusetts",11,25,11.11314795
1223,25013,Hampden County, Massachusetts,38.6,468072,41967,5073,524,4549,11256,4629,6627,9724,6686,3038,15914,12384,3530,80119,51005,27057,"Hampden County, Massachusetts",13,25,17.11681109
1224,25015,Hampshire County, Massachusetts,36,161035,12635,3167,52,3115,3490,1276,2214,2754,1912,842,3224,2600,624,20315,62608,31051,"Hampshire County, Massachusetts",15,25,12.61526997
1225,25017,Middlesex County, Massachusetts,38.5,1567610,312838,56442,3018,53424,94360,29848,64512,69878,45637,24241,92158,74685,17473,124652,89019,45579,"Middlesex County, Massachusetts",17,25,7.951722686
1226,25019,Nantucket County, Massachusetts,39.1,10694,1886,320,45,275,801,252,549,408,253,155,357,231,126,1083,89428,46009,"Nantucket County, Massachusetts",19,25,10.12717412
1227,25021,Norfolk County, Massachusetts,41,691218,115729,19327,1303,18024,31033,13422,17611,26672,20368,6304,38697,33868,4829,45372,90226,47306,"Norfolk County, Massachusetts",21,25,6.564065172
1228,25023,Plymouth County, Massachusetts,42.4,506657,43660,6441,691,5750,11689,5465,6224,9143,6469,2674,16387,13627,2760,39602,77627,37188,"Plymouth County, Massachusetts",23,25,7.816333338
1229,25025,Suffolk County, Massachusetts,32.4,767719,221137,46121,3199,42922,64007,22392,41615,53124,32249,20875,57885,44184,13701,145744,57439,35844,"Suffolk County, Massachusetts",25,25,18.98402931
1230,25027,Worcester County, Massachusetts,39.9,813589,94148,14872,1375,13497,30025,10537,19488,23074,16369,6705,26177,20988,5189,89860,67005,33272,"Worcester County, Massachusetts",27,25,11.04488876
1231,26001,Alcona County, Michigan,57.4,10461,180,12,0,12,17,11,6,12,7,5,139,96,43,1536,38160,23380,"Alcona County, Michigan",1,26,14.68310869
1232,26003,Alger County, Michigan,49,9396,87,17,0,17,4,0,4,8,4,4,58,34,24,1096,41270,20993,"Alger County, Michigan",3,26,11.6645381
1233,26005,Allegan County, Michigan,40,113666,3215,367,31,336,1054,311,743,558,203,355,1236,1017,219,13093,55630,25840,"Allegan County, Michigan",5,26,11.51883589
1234,26007,Alpena County, Michigan,47.3,28929,336,29,0,29,49,28,21,68,39,29,190,120,70,4615,39832,22776,"Alpena County, Michigan",7,26,15.95285008
1235,26009,Antrim County, Michigan,50,23215,468,44,0,44,131,32,99,46,34,12,247,179,68,2962,48825,28180,"Antrim County, Michigan",9,26,12.75899203
1236,26011,Arenac County, Michigan,48.9,15327,157,8,0,8,32,25,7,26,10,16,91,79,12,2897,39240,21602,"Arenac County, Michigan",11,26,18.90128531
1237,26013,Baraga County, Michigan,43.1,8612,168,25,0,25,68,31,37,6,2,4,69,57,12,947,42810,17664,"Baraga County, Michigan",13,26,10.99628425
1238,26015,Barry County, Michigan,42.6,59316,866,112,0,112,394,93,301,122,45,77,238,176,62,5461,56883,25909,"Barry County, Michigan",15,26,9.206622159
1239,26017,Bay County, Michigan,42.7,106107,1537,127,1,126,426,227,199,347,257,90,637,510,127,16515,45851,24753,"Bay County, Michigan",17,26,15.56447737
1240,26019,Benzie County, Michigan,48.6,17462,261,20,0,20,129,55,74,45,26,19,67,52,15,1926,48694,25506,"Benzie County, Michigan",19,26,11.02966441
1241,26021,Berrien County, Michigan,41.7,155134,9419,2076,33,2043,2729,415,2314,1843,822,1021,2771,2133,638,26963,45980,26309,"Berrien County, Michigan",21,26,17.38045818
1242,26023,Branch County, Michigan,40.8,43603,1393,266,85,181,577,215,362,282,167,115,268,198,70,7368,46428,21838,"Branch County, Michigan",23,26,16.89791987
1243,26025,Calhoun County, Michigan,40,134691,4820,1365,19,1346,1492,343,1149,773,338,435,1190,895,295,22245,44681,23812,"Calhoun County, Michigan",25,26,16.51558011
1244,26027,Cass County, Michigan,44.6,51795,743,87,0,87,180,86,94,119,77,42,357,172,185,7636,47991,25955,"Cass County, Michigan",27,26,14.74273579
1245,26029,Charlevoix County, Michigan,47.3,26172,490,160,37,123,76,40,36,62,21,41,192,149,43,3208,48603,29581,"Charlevoix County, Michigan",29,26,12.25737429
1246,26031,Cheboygan County, Michigan,49.6,25579,337,12,0,12,39,13,26,78,32,46,208,189,19,4704,41023,24220,"Cheboygan County, Michigan",31,26,18.39008562
1247,26033,Chippewa County, Michigan,39.8,38330,1067,175,3,172,231,78,153,249,82,167,412,290,122,5995,42287,20839,"Chippewa County, Michigan",33,26,15.64049048
1248,26035,Clare County, Michigan,46.5,30608,371,26,0,26,57,41,16,77,58,19,211,143,68,7289,34911,20418,"Clare County, Michigan",35,26,23.81403555
1249,26037,Clinton County, Michigan,40.4,77245,2089,465,0,465,637,174,463,320,152,168,667,545,122,8665,62646,31170,"Clinton County, Michigan",37,26,11.21755453
1250,26039,Crawford County, Michigan,49.7,13840,260,23,0,23,37,21,16,16,12,4,184,117,67,2326,41034,22348,"Crawford County, Michigan",39,26,16.80635838
1251,26041,Delta County, Michigan,46.6,36570,410,22,7,15,113,26,87,53,40,13,222,204,18,5961,42353,24182,"Delta County, Michigan",41,26,16.3002461
1252,26043,Dickinson County, Michigan,46.5,25889,311,40,19,21,53,46,7,52,35,17,166,128,38,3720,43373,25136,"Dickinson County, Michigan",43,26,14.36903704
1253,26045,Eaton County, Michigan,41,108544,3679,761,25,736,1245,360,885,620,418,202,1053,860,193,11895,56472,28624,"Eaton County, Michigan",45,26,10.95868956
1254,26047,Emmet County, Michigan,44.8,33091,666,89,0,89,147,31,116,59,25,34,371,302,69,3426,51096,30250,"Emmet County, Michigan",47,26,10.35326826
1255,26049,Genesee County, Michigan,39.9,413090,9977,1253,65,1188,2401,856,1545,1849,1430,419,4474,3807,667,85283,43246,23755,"Genesee County, Michigan",49,26,20.64513786
1256,26051,Gladwin County, Michigan,49.1,25367,227,10,0,10,12,0,12,29,18,11,176,145,31,5099,39629,22255,"Gladwin County, Michigan",51,26,20.10091852
1257,26053,Gogebic County, Michigan,48.5,15650,203,32,0,32,11,9,2,20,8,12,140,105,35,2908,35833,21464,"Gogebic County, Michigan",53,26,18.58146965
1258,26055,Grand Traverse County, Michigan,42.5,90715,2197,203,23,180,522,297,225,607,350,257,865,432,433,8649,55597,30024,"Grand Traverse County, Michigan",55,26,9.534255636
1259,26057,Gratiot County, Michigan,39.2,41676,466,59,12,47,110,4,106,81,41,40,216,183,33,6807,42145,20358,"Gratiot County, Michigan",57,26,16.33314138
1260,26059,Hillsdale County, Michigan,41.9,46024,434,72,0,72,68,43,25,121,89,32,173,127,46,8261,44458,22435,"Hillsdale County, Michigan",59,26,17.94933078
1261,26061,Houghton County, Michigan,33,36565,1736,816,7,809,433,106,327,206,74,132,281,230,51,7821,39080,20248,"Houghton County, Michigan",61,26,21.38930671
1262,26063,Huron County, Michigan,48.3,32021,483,54,6,48,125,48,77,87,46,41,217,129,88,4399,43082,24455,"Huron County, Michigan",63,26,13.73785953
1263,26065,Ingham County, Michigan,31.6,284559,25134,10106,209,9897,6112,1893,4219,3947,2595,1352,4969,4147,822,59145,46842,26083,"Ingham County, Michigan",65,26,20.78479331
1264,26067,Ionia County, Michigan,38.2,64126,965,49,0,49,242,97,145,157,63,94,517,353,164,8597,50037,21526,"Ionia County, Michigan",67,26,13.40641861
1265,26069,Iosco County, Michigan,52.1,25373,544,50,0,50,78,20,58,104,15,89,312,240,72,4205,38900,23723,"Iosco County, Michigan",69,26,16.5727348
1266,26071,Iron County, Michigan,53.5,11393,140,5,0,5,46,1,45,21,11,10,68,46,22,1907,33137,22454,"Iron County, Michigan",71,26,16.73834811
1267,26073,Isabella County, Michigan,27,70574,2422,1130,69,1061,564,144,420,358,261,97,370,294,76,18428,40706,21387,"Isabella County, Michigan",73,26,26.11159917
1268,26075,Jackson County, Michigan,40.8,159483,2485,475,19,456,678,281,397,358,160,198,974,623,351,25032,47709,24444,"Jackson County, Michigan",75,26,15.69571678
1269,26077,Kalamazoo County, Michigan,34.1,258605,11593,2336,110,2226,3315,847,2468,2364,1527,837,3578,2676,902,43657,49693,27370,"Kalamazoo County, Michigan",77,26,16.88173083
1270,26079,Kalkaska County, Michigan,44.6,17259,250,60,8,52,22,13,9,45,4,41,123,47,76,2839,42612,22508,"Kalkaska County, Michigan",79,26,16.44938872
1271,26081,Kent County, Michigan,34.9,629352,49216,8346,365,7981,13799,3576,10223,15423,7119,8304,11648,8484,3164,92049,54673,28070,"Kent County, Michigan",81,26,14.62599626
1272,26083,Keweenaw County, Michigan,55.1,2195,27,7,0,7,2,2,0,0,0,0,18,13,5,371,41472,26328,"Keweenaw County, Michigan",83,26,16.90205011
1273,26085,Lake County, Michigan,51.8,11415,151,30,14,16,11,3,8,24,3,21,86,48,38,3001,30824,17178,"Lake County, Michigan",85,26,26.28996934
1274,26087,Lapeer County, Michigan,43.5,88310,2456,214,0,214,362,82,280,509,291,218,1371,972,399,8914,54174,25373,"Lapeer County, Michigan",87,26,10.09398709
1275,26089,Leelanau County, Michigan,53.3,21764,747,73,0,73,248,134,114,103,39,64,323,244,79,1872,59018,35954,"Leelanau County, Michigan",89,26,8.601360044
1276,26091,Lenawee County, Michigan,41.2,98673,1797,199,8,191,403,141,262,384,141,243,811,595,216,13434,49300,24512,"Lenawee County, Michigan",91,26,13.61466663
1277,26093,Livingston County, Michigan,42.5,185841,5325,543,87,456,1000,471,529,1327,845,482,2455,1917,538,10972,76764,35156,"Livingston County, Michigan",93,26,5.903971675
1278,26095,Luce County, Michigan,44.5,6451,99,25,0,25,27,11,16,12,5,7,35,10,25,1140,38167,18444,"Luce County, Michigan",95,26,17.67167881
1279,26097,Mackinac County, Michigan,51.7,10998,273,106,0,106,45,14,31,23,14,9,99,88,11,1687,40747,25604,"Mackinac County, Michigan",97,26,15.33915257
1280,26099,Macomb County, Michigan,40.9,859703,90947,12663,953,11710,24204,12076,12128,21369,16232,5137,32711,26711,6000,102536,55951,28588,"Macomb County, Michigan",99,26,11.92690964
1281,26101,Manistee County, Michigan,48.5,24465,298,63,0,63,36,2,34,54,34,20,145,105,40,3723,42530,23290,"Manistee County, Michigan",101,26,15.21765788
1282,26103,Marquette County, Michigan,38.9,67418,1209,263,71,192,278,108,170,188,109,79,480,401,79,10403,46822,24275,"Marquette County, Michigan",103,26,15.43059717
1283,26105,Mason County, Michigan,45.8,28755,577,24,5,19,142,38,104,81,5,76,330,226,104,4601,43497,24643,"Mason County, Michigan",105,26,16.00069553
1284,26107,Mecosta County, Michigan,35.8,43259,904,233,3,230,293,30,263,154,106,48,224,155,69,9084,41827,20690,"Mecosta County, Michigan",107,26,20.99909845
1285,26109,Menominee County, Michigan,47.8,23568,214,5,0,5,74,30,44,20,13,7,115,70,45,3492,41235,24789,"Menominee County, Michigan",109,26,14.81670061
1286,26111,Midland County, Michigan,41.3,83559,2962,720,0,720,1047,359,688,610,251,359,585,472,113,10065,54852,31135,"Midland County, Michigan",111,26,12.04538111
1287,26113,Missaukee County, Michigan,43.2,15032,269,21,7,14,120,19,101,46,26,20,82,70,12,2234,42077,21124,"Missaukee County, Michigan",113,26,14.86162853
1288,26115,Monroe County, Michigan,41.9,149945,3147,286,54,232,743,261,482,588,355,233,1530,1086,444,16078,56968,27809,"Monroe County, Michigan",115,26,10.72259829
1289,26117,Montcalm County, Michigan,40.4,62922,774,71,0,71,175,72,103,145,54,91,383,288,95,10448,43126,20504,"Montcalm County, Michigan",117,26,16.60468517
1290,26119,Montmorency County, Michigan,55,9317,101,14,0,14,31,7,24,5,5,0,51,37,14,1496,37145,21621,"Montmorency County, Michigan",119,26,16.0566706
1291,26121,Muskegon County, Michigan,39,172148,2658,234,17,217,678,316,362,667,285,382,1079,738,341,32351,43920,21614,"Muskegon County, Michigan",121,26,18.7925506
1292,26123,Newaygo County, Michigan,42.7,47957,949,86,3,83,229,70,159,224,64,160,410,263,147,8596,44049,21905,"Newaygo County, Michigan",123,26,17.9243906
1293,26125,Oakland County, Michigan,40.9,1235215,150318,29930,1506,28424,39742,13914,25828,33493,23978,9515,47153,41161,5992,117008,69850,38992,"Oakland County, Michigan",125,26,9.472682893
1294,26127,Oceana County, Michigan,42.6,26152,1459,235,0,235,473,52,421,426,79,347,325,169,156,5136,41952,20760,"Oceana County, Michigan",127,26,19.63903334
1295,26129,Ogemaw County, Michigan,49.5,21103,314,56,11,45,67,3,64,12,5,7,179,137,42,4135,36941,21515,"Ogemaw County, Michigan",129,26,19.59437047
1296,26131,Ontonagon County, Michigan,56.6,6165,109,10,0,10,42,30,12,9,9,0,48,34,14,928,35038,22428,"Ontonagon County, Michigan",131,26,15.05271695
1297,26133,Osceola County, Michigan,43.1,23172,211,43,13,30,13,6,7,43,21,22,112,75,37,5172,39247,19853,"Osceola County, Michigan",133,26,22.32004143
1298,26135,Oscoda County, Michigan,51.6,8374,107,1,0,1,19,0,19,16,16,0,71,47,24,1621,35175,20047,"Oscoda County, Michigan",135,26,19.35753523
1299,26137,Otsego County, Michigan,44.6,24198,416,68,0,68,137,17,120,61,23,38,150,145,5,3365,50793,25655,"Otsego County, Michigan",137,26,13.90610794
1300,26139,Ottawa County, Michigan,34.7,276583,15872,2670,288,2382,4270,1426,2844,3547,1972,1575,5385,4081,1304,26511,61367,27696,"Ottawa County, Michigan",139,26,9.58518781
1301,26141,Presque Isle County, Michigan,53.9,12955,150,18,0,18,34,1,33,11,10,1,87,73,14,1729,41570,23862,"Presque Isle County, Michigan",141,26,13.34619838
1302,26143,Roscommon County, Michigan,54.9,23900,353,24,0,24,31,2,29,32,24,8,266,184,82,4644,35959,21807,"Roscommon County, Michigan",143,26,19.43096234
1303,26145,Saginaw County, Michigan,40.4,195201,4639,1115,16,1099,1067,258,809,765,508,257,1692,1394,298,33795,43712,24020,"Saginaw County, Michigan",145,26,17.3129236
1304,26147,St. Clair County, Michigan,42.9,160069,4389,356,32,324,934,463,471,669,354,315,2430,1800,630,22366,50930,26377,"St. Clair County, Michigan",147,26,13.97272426
1305,26149,St. Joseph County, Michigan,39.3,60923,2016,184,18,166,544,100,444,644,110,534,644,399,245,9697,45410,22182,"St. Joseph County, Michigan",149,26,15.91681303
1306,26151,Sanilac County, Michigan,44.6,41761,593,44,9,35,97,45,52,55,31,24,397,298,99,6476,42037,22510,"Sanilac County, Michigan",151,26,15.50729149
1307,26153,Schoolcraft County, Michigan,50.4,8186,160,0,0,0,0,0,0,95,95,0,65,50,15,1728,36649,20975,"Schoolcraft County, Michigan",153,26,21.10921085
1308,26155,Shiawassee County, Michigan,41.7,68800,669,53,1,52,233,90,143,104,81,23,279,230,49,9649,48470,23927,"Shiawassee County, Michigan",155,26,14.0247093
1309,26157,Tuscola County, Michigan,43.8,54014,524,83,7,76,115,40,75,104,73,31,222,120,102,8330,44193,22511,"Tuscola County, Michigan",157,26,15.42192765
1310,26159,Van Buren County, Michigan,41.4,75216,3589,387,11,376,847,156,691,1015,476,539,1340,836,504,12998,47141,23943,"Van Buren County, Michigan",159,26,17.28089768
1311,26161,Washtenaw County, Michigan,33.4,358082,41751,11612,441,11171,11611,3285,8326,9043,6088,2955,9485,7702,1783,51476,62484,35888,"Washtenaw County, Michigan",161,26,14.37547824
1312,26163,Wayne County, Michigan,37.8,1767593,146781,21749,2254,19495,44047,19209,24838,38517,25108,13409,42468,34534,7934,428189,42043,23666,"Wayne County, Michigan",163,26,24.22441139
1313,26165,Wexford County, Michigan,41.9,32829,376,34,0,34,95,24,71,86,80,6,161,147,14,6080,40417,21200,"Wexford County, Michigan",165,26,18.52021079
1314,27001,Aitkin County, Minnesota,53.6,15722,155,11,8,3,42,17,25,13,7,6,89,66,23,1978,44524,25780,"Aitkin County, Minnesota",1,27,12.58109655
1315,27003,Anoka County, Minnesota,37.9,341249,24924,2666,389,2277,9070,4154,4916,7214,5144,2070,5974,4814,1160,24864,73579,33051,"Anoka County, Minnesota",3,27,7.286175198
1316,27005,Becker County, Minnesota,42.2,33375,579,245,0,245,99,68,31,76,56,20,159,126,33,4209,54115,27188,"Becker County, Minnesota",5,27,12.61123596
1317,27007,Beltrami County, Minnesota,33.4,45644,836,200,29,171,293,97,196,104,78,26,239,195,44,8247,45201,22845,"Beltrami County, Minnesota",7,27,18.06809219
1318,27009,Benton County, Minnesota,35.8,39457,1153,247,71,176,544,173,371,106,73,33,256,218,38,5220,51841,25984,"Benton County, Minnesota",9,27,13.22959171
1319,27011,Big Stone County, Minnesota,49.2,5098,48,3,0,3,35,25,10,1,0,1,9,9,0,562,47132,27820,"Big Stone County, Minnesota",11,27,11.02393095
1320,27013,Blue Earth County, Minnesota,30.5,65524,2707,932,7,925,789,378,411,627,378,249,359,303,56,11323,52119,27324,"Blue Earth County, Minnesota",13,27,17.28069104
1321,27015,Brown County, Minnesota,43.3,25327,533,131,41,90,116,91,25,75,17,58,211,139,72,1925,53319,28444,"Brown County, Minnesota",15,27,7.600584357
1322,27017,Carlton County, Minnesota,41.1,35482,388,75,10,65,100,57,43,79,53,26,134,107,27,4507,55607,25714,"Carlton County, Minnesota",17,27,12.70221521
1323,27019,Carver County, Minnesota,37.1,97143,4880,537,5,532,1860,809,1051,1344,837,507,1139,893,246,3957,88638,41759,"Carver County, Minnesota",19,27,4.073376363
1324,27021,Cass County, Minnesota,48.4,28633,286,66,4,62,57,38,19,36,25,11,127,92,35,4468,47926,26844,"Cass County, Minnesota",21,27,15.60437258
1325,27023,Chippewa County, Minnesota,43.1,12126,493,119,0,119,259,12,247,69,52,17,46,32,14,1285,54041,27781,"Chippewa County, Minnesota",23,27,10.59706416
1326,27025,Chisago County, Minnesota,40.7,54041,850,34,8,26,229,68,161,194,125,69,393,297,96,3137,72908,30455,"Chisago County, Minnesota",25,27,5.804851872
1327,27027,Clay County, Minnesota,32.6,61402,2280,754,11,743,455,223,232,682,449,233,389,339,50,6827,59614,27165,"Clay County, Minnesota",27,27,11.11853034
1328,27029,Clearwater County, Minnesota,42.6,8764,94,18,0,18,30,11,19,9,3,6,37,34,3,1435,44203,23777,"Clearwater County, Minnesota",29,27,16.37380192
1329,27031,Cook County, Minnesota,51.8,5215,246,112,1,111,47,3,44,7,6,1,80,65,15,617,51793,32774,"Cook County, Minnesota",31,27,11.83125599
1330,27033,Cottonwood County, Minnesota,43.2,11557,515,82,11,71,197,87,110,100,34,66,136,81,55,1802,47407,25967,"Cottonwood County, Minnesota",33,27,15.59228173
1331,27035,Crow Wing County, Minnesota,43.8,63321,962,163,0,163,260,160,100,105,89,16,434,347,87,6531,50893,29106,"Crow Wing County, Minnesota",35,27,10.3141138
1332,27037,Dakota County, Minnesota,37.6,411402,36706,4168,426,3742,13480,5810,7670,9879,6304,3575,9179,7639,1540,29265,77321,37266,"Dakota County, Minnesota",37,27,7.113480246
1333,27039,Dodge County, Minnesota,37.8,20361,426,62,0,62,163,25,138,113,34,79,88,85,3,1341,68718,30495,"Dodge County, Minnesota",39,27,6.586120525
1334,27041,Douglas County, Minnesota,44.4,36862,414,14,8,6,86,57,29,68,48,20,246,191,55,3141,56347,31640,"Douglas County, Minnesota",41,27,8.520970105
1335,27043,Faribault County, Minnesota,46.9,14119,316,6,4,2,96,32,64,160,48,112,54,37,17,1728,49101,28168,"Faribault County, Minnesota",43,27,12.23882711
1336,27045,Fillmore County, Minnesota,43,20877,272,119,0,119,88,43,45,23,1,22,42,37,5,2476,54358,27777,"Fillmore County, Minnesota",45,27,11.85994156
1337,27047,Freeborn County, Minnesota,44.4,30751,1202,101,3,98,473,60,413,271,116,155,357,218,139,3383,48827,27332,"Freeborn County, Minnesota",47,27,11.00126825
1338,27049,Goodhue County, Minnesota,43.3,46450,1431,152,2,150,563,69,494,353,241,112,363,229,134,4980,60452,31830,"Goodhue County, Minnesota",49,27,10.7212056
1339,27051,Grant County, Minnesota,45.9,5943,64,0,0,0,18,0,18,21,19,2,25,20,5,676,53828,29446,"Grant County, Minnesota",51,27,11.37472657
1340,27053,Hennepin County, Minnesota,36.2,1209265,162552,30196,2257,27939,59288,24347,34941,41080,26237,14843,31988,25949,6039,141453,67989,39939,"Hennepin County, Minnesota",53,27,11.69743605
1341,27055,Houston County, Minnesota,45.4,18791,198,35,2,33,22,10,12,34,29,5,107,104,3,1910,55550,29007,"Houston County, Minnesota",55,27,10.16444042
1342,27057,Hubbard County, Minnesota,48.3,20640,284,62,0,62,86,39,47,68,58,10,68,56,12,2363,49742,26417,"Hubbard County, Minnesota",57,27,11.44864341
1343,27059,Isanti County, Minnesota,39.5,38461,549,120,55,65,163,67,96,18,14,4,248,186,62,2732,62733,28676,"Isanti County, Minnesota",59,27,7.103299446
1344,27061,Itasca County, Minnesota,45.9,45356,458,55,3,52,66,39,27,76,42,34,261,211,50,5886,49507,25862,"Itasca County, Minnesota",61,27,12.97733486
1345,27063,Jackson County, Minnesota,43.4,10163,217,36,0,36,43,8,35,57,15,42,81,20,61,895,55114,28958,"Jackson County, Minnesota",63,27,8.806454787
1346,27065,Kanabec County, Minnesota,44.3,15918,146,53,12,41,28,13,15,12,2,10,53,33,20,2130,48042,24582,"Kanabec County, Minnesota",65,27,13.38107802
1347,27067,Kandiyohi County, Minnesota,39.6,42510,3012,883,98,785,1132,281,851,449,218,231,548,394,154,4732,53514,28165,"Kandiyohi County, Minnesota",67,27,11.13149847
1348,27069,Kittson County, Minnesota,48,4436,90,13,0,13,5,1,4,17,12,5,55,42,13,481,51484,29939,"Kittson County, Minnesota",69,27,10.84310189
1349,27071,Koochiching County, Minnesota,48.2,12930,719,34,2,32,94,43,51,149,53,96,442,303,139,2139,44929,26814,"Koochiching County, Minnesota",71,27,16.54292343
1350,27073,Lac qui Parle County, Minnesota,50,6916,112,16,6,10,56,9,47,1,1,0,39,29,10,574,49210,30816,"Lac qui Parle County, Minnesota",73,27,8.299595142
1351,27075,Lake County, Minnesota,50.4,10721,256,62,5,57,30,4,26,57,17,40,107,94,13,1255,52320,31215,"Lake County, Minnesota",75,27,11.70599757
1352,27077,Lake of the Woods County, Minnesota,50.8,3901,61,23,0,23,1,1,0,3,0,3,34,8,26,312,45732,23234,"Lake of the Woods County, Minnesota",77,27,7.997949244
1353,27079,Le Sueur County, Minnesota,41.5,27650,779,35,0,35,288,38,250,206,60,146,250,103,147,2339,62462,29714,"Le Sueur County, Minnesota",79,27,8.459312839
1354,27081,Lincoln County, Minnesota,46.3,5793,41,2,2,0,17,14,3,9,2,7,13,13,0,652,49438,27946,"Lincoln County, Minnesota",81,27,11.25496289
1355,27083,Lyon County, Minnesota,35.4,25670,1637,586,6,580,323,140,183,350,160,190,378,232,146,3396,51920,28860,"Lyon County, Minnesota",83,27,13.22945072
1356,27085,McLeod County, Minnesota,40.4,35926,1196,150,16,134,435,62,373,385,162,223,226,138,88,2885,57738,28241,"McLeod County, Minnesota",85,27,8.030395814
1357,27087,Mahnomen County, Minnesota,36.1,5480,43,9,0,9,4,2,2,4,4,0,26,24,2,1209,41597,20233,"Mahnomen County, Minnesota",87,27,22.0620438
1358,27089,Marshall County, Minnesota,43.6,9406,164,10,1,9,43,16,27,30,19,11,81,43,38,698,56340,28194,"Marshall County, Minnesota",89,27,7.420795237
1359,27091,Martin County, Minnesota,45.2,20193,480,43,17,26,81,48,33,297,40,257,59,55,4,2308,51984,29034,"Martin County, Minnesota",91,27,11.42970336
1360,27093,Meeker County, Minnesota,42.1,23094,511,91,5,86,224,60,164,72,33,39,124,64,60,2116,58574,27974,"Meeker County, Minnesota",93,27,9.162553044
1361,27095,Mille Lacs County, Minnesota,40.6,25788,394,29,3,26,93,69,24,75,43,32,197,157,40,2970,51232,24489,"Mille Lacs County, Minnesota",95,27,11.51698464
1362,27097,Morrison County, Minnesota,41.5,32850,307,59,30,29,114,53,61,29,16,13,105,59,46,3801,51456,26442,"Morrison County, Minnesota",97,27,11.57077626
1363,27099,Mower County, Minnesota,39.5,39248,3159,805,0,805,1478,385,1093,398,163,235,478,388,90,5403,51778,27459,"Mower County, Minnesota",99,27,13.76630656
1364,27101,Murray County, Minnesota,47.6,8463,210,40,4,36,104,4,100,26,20,6,40,23,17,761,51801,29084,"Murray County, Minnesota",101,27,8.992083186
1365,27103,Nicollet County, Minnesota,35.8,33226,1357,291,0,291,557,176,381,284,163,121,225,169,56,3655,61501,28089,"Nicollet County, Minnesota",103,27,11.00042136
1366,27105,Nobles County, Minnesota,35.8,21729,4407,638,110,528,2225,453,1772,773,158,615,771,391,380,3004,53269,24188,"Nobles County, Minnesota",105,27,13.82484238
1367,27107,Norman County, Minnesota,44.9,6638,117,50,0,50,26,13,13,18,6,12,23,18,5,761,52083,26270,"Norman County, Minnesota",107,27,11.46429647
1368,27109,Olmsted County, Minnesota,36.8,150104,15857,3076,181,2895,5559,2230,3329,3296,2415,881,3926,3036,890,13635,69308,36143,"Olmsted County, Minnesota",109,27,9.083701967
1369,27111,Otter Tail County, Minnesota,46.8,57694,1372,288,44,244,341,70,271,307,159,148,436,267,169,5497,53351,28781,"Otter Tail County, Minnesota",111,27,9.52785385
1370,27113,Pennington County, Minnesota,39.6,14156,244,46,15,31,63,19,44,50,39,11,85,66,19,1211,51156,26992,"Pennington County, Minnesota",113,27,8.554676462
1371,27115,Pine County, Minnesota,44,29067,491,15,0,15,107,51,56,129,33,96,240,169,71,3737,45379,22817,"Pine County, Minnesota",115,27,12.85650394
1372,27117,Pipestone County, Minnesota,42.4,9285,343,17,0,17,185,22,163,57,10,47,84,76,8,1155,48944,27489,"Pipestone County, Minnesota",117,27,12.43941842
1373,27119,Polk County, Minnesota,38.5,31550,974,358,42,316,193,108,85,163,20,143,260,190,70,3950,53059,27231,"Polk County, Minnesota",119,27,12.51980983
1374,27121,Pope County, Minnesota,46.4,10975,107,16,0,16,12,10,2,18,3,15,61,46,15,1026,55180,30485,"Pope County, Minnesota",121,27,9.348519362
1375,27123,Ramsey County, Minnesota,34.6,531528,80250,15829,985,14844,28871,12403,16468,17619,12114,5505,17931,14734,3197,82252,57717,31256,"Ramsey County, Minnesota",123,27,15.47463163
1376,27125,Red Lake County, Minnesota,42.1,4042,48,8,2,6,8,1,7,17,2,15,15,15,0,418,49800,25732,"Red Lake County, Minnesota",125,27,10.34141514
1377,27127,Redwood County, Minnesota,43.5,15578,346,35,13,22,109,41,68,80,22,58,122,68,54,1767,48891,26716,"Redwood County, Minnesota",127,27,11.3429195
1378,27129,Renville County, Minnesota,44.8,14995,406,66,18,48,101,36,65,97,26,71,142,52,90,1533,54824,30089,"Renville County, Minnesota",129,27,10.2234078
1379,27131,Rice County, Minnesota,36.5,65116,4836,1181,9,1172,1941,609,1332,1048,249,799,666,434,232,6678,61683,27856,"Rice County, Minnesota",131,27,10.25554395
1380,27133,Rock County, Minnesota,41.6,9554,169,5,1,4,47,13,34,44,16,28,73,33,40,998,52835,27634,"Rock County, Minnesota",133,27,10.44588654
1381,27135,Roseau County, Minnesota,41.1,15609,569,43,17,26,157,75,82,106,68,38,263,152,111,1286,54827,27307,"Roseau County, Minnesota",135,27,8.238836569
1382,27137,St. Louis County, Minnesota,41.1,200353,4378,970,61,909,1001,575,426,873,589,284,1534,1231,303,29875,49395,28013,"St. Louis County, Minnesota",137,27,14.91118176
1383,27139,Scott County, Minnesota,35.7,139490,11159,1161,123,1038,3179,1432,1747,3851,2494,1357,2968,2351,617,7905,90198,37113,"Scott County, Minnesota",139,27,5.667072908
1384,27141,Sherburne County, Minnesota,35.5,91188,2600,364,19,345,833,447,386,823,487,336,580,382,198,6382,78081,31182,"Sherburne County, Minnesota",141,27,6.998727903
1385,27143,Sibley County, Minnesota,41.7,14957,726,129,11,118,282,65,217,183,52,131,132,94,38,1442,59596,28811,"Sibley County, Minnesota",143,27,9.640970783
1386,27145,Stearns County, Minnesota,34.1,153661,8586,3097,291,2806,2957,1144,1813,1412,902,510,1120,896,224,19983,56977,27792,"Stearns County, Minnesota",145,27,13.00460104
1387,27147,Steele County, Minnesota,39.5,36541,1260,97,43,54,476,236,240,411,247,164,276,226,50,3396,58141,28736,"Steele County, Minnesota",147,27,9.293670124
1388,27149,Stevens County, Minnesota,32.9,9762,407,217,0,217,148,89,59,4,2,2,38,27,11,1637,55941,26625,"Stevens County, Minnesota",149,27,16.76910469
1389,27151,Swift County, Minnesota,44.2,9483,175,53,0,53,60,35,25,46,25,21,16,8,8,1155,49956,28969,"Swift County, Minnesota",151,27,12.17968997
1390,27153,Todd County, Minnesota,43.1,24335,858,36,2,34,410,49,361,273,102,171,139,63,76,3253,47549,24410,"Todd County, Minnesota",153,27,13.36757756
1391,27155,Traverse County, Minnesota,49.1,3397,62,5,0,5,30,0,30,0,0,0,27,27,0,305,50333,30992,"Traverse County, Minnesota",155,27,8.97851045
1392,27157,Wabasha County, Minnesota,43.9,21327,289,19,0,19,154,22,132,23,19,4,93,72,21,1399,58865,31464,"Wabasha County, Minnesota",157,27,6.559759929
1393,27159,Wadena County, Minnesota,43,13755,108,14,0,14,16,10,6,13,13,0,65,58,7,2081,42689,22283,"Wadena County, Minnesota",159,27,15.12904398
1394,27161,Waseca County, Minnesota,39.4,19034,643,28,7,21,130,29,101,335,164,171,150,85,65,1387,53199,27179,"Waseca County, Minnesota",161,27,7.286960177
1395,27163,Washington County, Minnesota,39,248745,16215,1870,70,1800,4886,2073,2813,4665,3450,1215,4794,4362,432,12496,86689,39873,"Washington County, Minnesota",163,27,5.023618565
1396,27165,Watonwan County, Minnesota,39.7,10996,1225,253,5,248,410,34,376,342,108,234,220,142,78,1272,50068,26273,"Watonwan County, Minnesota",165,27,11.56784285
1397,27167,Wilkin County, Minnesota,44.1,6479,31,0,0,0,7,7,0,9,4,5,15,11,4,577,52963,27814,"Wilkin County, Minnesota",167,27,8.905695323
1398,27169,Winona County, Minnesota,34,51145,1849,391,0,391,505,180,325,319,133,186,634,446,188,6539,52840,25967,"Winona County, Minnesota",169,27,12.7852185
1399,27171,Wright County, Minnesota,35.8,129922,3743,486,118,368,1178,601,577,1128,617,511,951,827,124,7150,75705,31154,"Wright County, Minnesota",171,27,5.503301981
1400,27173,Yellow Medicine County, Minnesota,43,10038,149,8,0,8,54,14,40,51,30,21,36,29,7,1115,54717,27686,"Yellow Medicine County, Minnesota",173,27,11.1077904
1401,28001,Adams County, Mississippi,40.4,31747,2494,798,14,784,707,336,371,479,153,326,510,128,382,8905,31283,18091,"Adams County, Mississippi",1,28,28.04989448
1402,28003,Alcorn County, Mississippi,39.7,37309,628,167,0,167,216,3,213,58,4,54,187,119,68,7305,38892,20006,"Alcorn County, Mississippi",3,28,19.57972607
1403,28005,Amite County, Mississippi,46.1,12692,54,2,0,2,11,0,11,0,0,0,41,18,23,3519,27334,17954,"Amite County, Mississippi",5,28,27.72612669
1404,28007,Attala County, Mississippi,40.6,19085,142,32,0,32,27,0,27,52,36,16,31,23,8,4574,33018,20283,"Attala County, Mississippi",7,28,23.96646581
1405,28009,Benton County, Mississippi,42.1,8378,71,0,0,0,34,0,34,31,8,23,6,2,4,1882,36302,20261,"Benton County, Mississippi",9,28,22.46359513
1406,28011,Bolivar County, Mississippi,34.9,33615,631,5,5,0,163,9,154,249,180,69,214,197,17,12097,27457,16595,"Bolivar County, Mississippi",11,28,35.98691061
1407,28013,Calhoun County, Mississippi,40.5,14724,428,56,0,56,242,18,224,80,24,56,50,36,14,3791,31141,17203,"Calhoun County, Mississippi",13,28,25.7470796
1408,28015,Carroll County, Mississippi,45.2,10301,103,0,0,0,10,0,10,0,0,0,93,66,27,1759,40278,22519,"Carroll County, Mississippi",15,28,17.07601204
1409,28017,Chickasaw County, Mississippi,37.1,17357,458,25,0,25,132,30,102,250,47,203,51,43,8,4623,31048,18514,"Chickasaw County, Mississippi",17,28,26.63478712
1410,28019,Choctaw County, Mississippi,43,8320,22,11,0,11,9,9,0,0,0,0,2,0,2,1993,32953,18434,"Choctaw County, Mississippi",19,28,23.95432692
1411,28021,Claiborne County, Mississippi,33,9209,83,19,0,19,64,22,42,0,0,0,0,0,0,3554,25000,12944,"Claiborne County, Mississippi",21,28,38.59268107
1412,28023,Clarke County, Mississippi,42,16203,64,17,0,17,0,0,0,47,47,0,0,0,0,3087,36441,20431,"Clarke County, Mississippi",23,28,19.0520274
1413,28025,Clay County, Mississippi,38.6,20147,138,35,0,35,28,0,28,46,20,26,29,22,7,5159,33142,19097,"Clay County, Mississippi",25,28,25.60679009
1414,28027,Coahoma County, Mississippi,33.9,24804,193,31,0,31,99,59,40,22,22,0,41,41,0,8541,28217,16066,"Coahoma County, Mississippi",27,28,34.43396226
1415,28029,Copiah County, Mississippi,38,28780,739,135,23,112,294,210,84,146,60,86,164,126,38,7844,34738,18188,"Copiah County, Mississippi",29,28,27.25503822
1416,28031,Covington County, Mississippi,38.2,19503,72,11,0,11,32,10,22,12,12,0,17,17,0,4943,31684,16941,"Covington County, Mississippi",31,28,25.34481875
1417,28033,DeSoto County, Mississippi,36.2,170890,5715,811,54,757,1849,634,1215,1711,980,731,1344,973,371,16948,60111,27135,"DeSoto County, Mississippi",33,28,9.917490784
1418,28035,Forrest County, Mississippi,32,76274,2374,627,14,613,1244,106,1138,214,172,42,289,222,67,19870,37017,20194,"Forrest County, Mississippi",35,28,26.05081679
1419,28037,Franklin County, Mississippi,42.5,7818,34,25,21,4,6,0,6,0,0,0,3,3,0,1442,40081,22769,"Franklin County, Mississippi",37,28,18.44461499
1420,28039,George County, Mississippi,36.8,23313,432,165,162,3,133,31,102,94,81,13,40,40,0,4096,47313,20640,"George County, Mississippi",39,28,17.56959636
1421,28041,Greene County, Mississippi,37.4,13941,66,0,0,0,17,2,15,5,0,5,44,14,30,1914,40069,15659,"Greene County, Mississippi",41,28,13.72928771
1422,28043,Grenada County, Mississippi,40.3,21518,31,6,0,6,10,0,10,15,8,7,0,0,0,5090,33026,20562,"Grenada County, Mississippi",43,28,23.65461474
1423,28045,Hancock County, Mississippi,41.8,46028,988,86,19,67,359,105,254,53,53,0,490,379,111,8490,46542,23221,"Hancock County, Mississippi",45,28,18.44529417
1424,28047,Harrison County, Mississippi,35.7,198570,8688,1461,164,1297,2506,550,1956,1515,914,601,3206,2478,728,40538,43095,22517,"Harrison County, Mississippi",47,28,20.41496701
1425,28049,Hinds County, Mississippi,34,244596,4699,1167,56,1111,1660,466,1194,868,479,389,1004,737,267,60356,38773,21672,"Hinds County, Mississippi",49,28,24.67579192
1426,28051,Holmes County, Mississippi,33.8,18547,30,0,0,0,30,0,30,0,0,0,0,0,0,8046,20800,12408,"Holmes County, Mississippi",51,28,43.38167898
1427,28053,Humphreys County, Mississippi,35.6,8822,112,56,13,43,44,0,44,4,4,0,8,2,6,3706,23442,13977,"Humphreys County, Mississippi",53,28,42.00861483
1428,28055,Issaquena County, Mississippi,42.3,1352,5,0,0,0,0,0,0,0,0,0,5,5,0,431,24306,17282,"Issaquena County, Mississippi",55,28,31.87869822
1429,28057,Itawamba County, Mississippi,40,23511,171,43,0,43,6,0,6,65,18,47,57,48,9,4544,35380,19707,"Itawamba County, Mississippi",57,28,19.32712347
1430,28059,Jackson County, Mississippi,38,140850,4944,517,56,461,1277,397,880,1275,424,851,1875,1355,520,21818,49158,24350,"Jackson County, Mississippi",59,28,15.49023784
1431,28061,Jasper County, Mississippi,41.6,16538,53,0,0,0,22,5,17,0,0,0,31,31,0,3641,34993,19363,"Jasper County, Mississippi",61,28,22.01596324
1432,28063,Jefferson County, Mississippi,36.3,7528,47,0,0,0,10,0,10,37,37,0,0,0,0,2812,23773,13703,"Jefferson County, Mississippi",63,28,37.35387885
1433,28065,Jefferson Davis County, Mississippi,43.1,11771,20,0,0,0,0,0,0,10,10,0,10,10,0,4005,26429,16859,"Jefferson Davis County, Mississippi",65,28,34.024297
1434,28067,Jones County, Mississippi,36.8,68313,1860,75,0,75,916,86,830,655,156,499,214,110,104,15859,37846,20957,"Jones County, Mississippi",67,28,23.21520062
1435,28069,Kemper County, Mississippi,41.1,10128,3,0,0,0,0,0,0,0,0,0,3,3,0,2755,29925,14715,"Kemper County, Mississippi",69,28,27.20181675
1436,28071,Lafayette County, Mississippi,29.2,52193,1585,384,15,369,627,177,450,392,178,214,182,182,0,11902,43162,23833,"Lafayette County, Mississippi",71,28,22.80382427
1437,28073,Lamar County, Mississippi,34.3,59623,1738,108,8,100,1073,251,822,353,231,122,204,164,40,9535,53888,28101,"Lamar County, Mississippi",73,28,15.99215068
1438,28075,Lauderdale County, Mississippi,37.4,79233,1444,72,9,63,835,210,625,186,162,24,351,292,59,17541,38399,21575,"Lauderdale County, Mississippi",75,28,22.1385029
1439,28077,Lawrence County, Mississippi,40.1,12603,1,0,0,0,1,0,1,0,0,0,0,0,0,2736,38155,20700,"Lawrence County, Mississippi",77,28,21.70911688
1440,28079,Leake County, Mississippi,35.5,23011,382,0,0,0,188,0,188,165,0,165,29,19,10,6013,32657,18178,"Leake County, Mississippi",79,28,26.13098084
1441,28081,Lee County, Mississippi,36.9,85281,1556,110,0,110,672,65,607,532,335,197,242,137,105,15531,43224,22741,"Lee County, Mississippi",81,28,18.21155943
1442,28083,Leflore County, Mississippi,32.8,30500,592,43,0,43,335,9,326,117,46,71,97,89,8,11765,25356,15370,"Leflore County, Mississippi",83,28,38.57377049
1443,28085,Lincoln County, Mississippi,38.1,34691,108,29,29,0,15,15,0,38,38,0,26,20,6,8687,36250,19418,"Lincoln County, Mississippi",85,28,25.04107694
1444,28087,Lowndes County, Mississippi,36.9,59785,1597,424,49,375,613,307,306,113,75,38,447,352,95,12783,41219,22143,"Lowndes County, Mississippi",87,28,21.38161746
1445,28089,Madison County, Mississippi,37.1,101791,3920,755,19,736,1525,323,1202,906,683,223,734,578,156,12720,65924,35435,"Madison County, Mississippi",89,28,12.49619318
1446,28091,Marion County, Mississippi,39.8,25810,230,24,0,24,145,39,106,0,0,0,61,42,19,6840,30914,19707,"Marion County, Mississippi",91,28,26.50135606
1447,28093,Marshall County, Mississippi,39.5,36196,465,31,26,5,104,61,43,201,46,155,129,54,75,6230,40598,19104,"Marshall County, Mississippi",93,28,17.21184661
1448,28095,Monroe County, Mississippi,40.9,36029,161,0,0,0,65,21,44,23,0,23,73,54,19,7308,37345,19905,"Monroe County, Mississippi",95,28,20.28366038
1449,28097,Montgomery County, Mississippi,42.3,10353,31,26,0,26,0,0,0,0,0,0,5,5,0,2913,31207,19706,"Montgomery County, Mississippi",97,28,28.13677195
1450,28099,Neshoba County, Mississippi,36,29474,396,0,0,0,186,7,179,98,35,63,112,96,16,6463,35991,19030,"Neshoba County, Mississippi",99,28,21.92780077
1451,28101,Newton County, Mississippi,37.8,21652,205,13,0,13,152,68,84,7,2,5,33,13,20,4895,35527,20896,"Newton County, Mississippi",101,28,22.60761131
1452,28103,Noxubee County, Mississippi,36.1,11098,216,67,0,67,111,0,111,33,13,20,5,5,0,3510,31472,16108,"Noxubee County, Mississippi",103,28,31.62732024
1453,28105,Oktibbeha County, Mississippi,25.2,49424,2011,589,0,589,619,57,562,391,83,308,412,291,121,14343,33431,20128,"Oktibbeha County, Mississippi",105,28,29.02031402
1454,28107,Panola County, Mississippi,36.5,34319,290,148,0,148,88,7,81,0,0,0,54,54,0,7630,37556,20098,"Panola County, Mississippi",107,28,22.23258253
1455,28109,Pearl River County, Mississippi,40.9,55167,903,0,0,0,198,4,194,171,60,111,534,353,181,10886,41598,20653,"Pearl River County, Mississippi",109,28,19.73281128
1456,28111,Perry County, Mississippi,40.8,12174,30,0,0,0,0,0,0,0,0,0,30,23,7,2375,34774,18188,"Perry County, Mississippi",111,28,19.50878922
1457,28113,Pike County, Mississippi,36.9,39939,336,41,7,34,160,24,136,63,27,36,72,48,24,12290,31511,17316,"Pike County, Mississippi",113,28,30.77192719
1458,28115,Pontotoc County, Mississippi,37.3,30862,766,75,0,75,225,21,204,370,30,340,96,36,60,5517,39869,19743,"Pontotoc County, Mississippi",115,28,17.8763528
1459,28117,Prentiss County, Mississippi,39.5,25339,166,14,6,8,50,38,12,12,0,12,90,81,9,5485,33509,18313,"Prentiss County, Mississippi",117,28,21.64647382
1460,28119,Quitman County, Mississippi,39,7634,66,34,0,34,5,0,5,11,0,11,16,16,0,2799,24835,14928,"Quitman County, Mississippi",119,28,36.66492009
1461,28121,Rankin County, Mississippi,37.1,147930,3377,720,64,656,1237,293,944,433,166,267,987,765,222,13568,59370,27822,"Rankin County, Mississippi",121,28,9.171905631
1462,28123,Scott County, Mississippi,36.1,28268,1943,208,0,208,1091,34,1057,316,21,295,328,163,165,7412,32615,17203,"Scott County, Mississippi",123,28,26.2204613
1463,28125,Sharkey County, Mississippi,38.7,4662,37,13,0,13,6,6,0,0,0,0,18,2,16,1435,28878,15430,"Sharkey County, Mississippi",125,28,30.78078078
1464,28127,Simpson County, Mississippi,37.9,27279,212,24,0,24,125,6,119,25,0,25,38,38,0,7299,37285,18495,"Simpson County, Mississippi",127,28,26.75684593
1465,28129,Smith County, Mississippi,40.6,16137,27,1,0,1,5,0,5,5,4,1,16,16,0,3640,33696,22129,"Smith County, Mississippi",129,28,22.55685691
1466,28131,Stone County, Mississippi,37.6,17995,179,12,0,12,76,0,76,31,0,31,60,33,27,3513,44995,19588,"Stone County, Mississippi",131,28,19.52208947
1467,28133,Sunflower County, Mississippi,34.5,27424,171,11,0,11,22,18,4,46,13,33,92,82,10,8109,27126,14111,"Sunflower County, Mississippi",133,28,29.56899067
1468,28135,Tallahatchie County, Mississippi,35.2,14776,790,42,0,42,212,42,170,242,43,199,294,35,259,3002,29837,12747,"Tallahatchie County, Mississippi",135,28,20.31672983
1469,28137,Tate County, Mississippi,36.7,28338,479,63,0,63,249,67,182,85,54,31,82,34,48,4158,43883,20948,"Tate County, Mississippi",137,28,14.67287741
1470,28139,Tippah County, Mississippi,38.7,22061,578,10,0,10,300,14,286,228,0,228,40,22,18,5103,37109,19453,"Tippah County, Mississippi",139,28,23.13131771
1471,28141,Tishomingo County, Mississippi,42.7,19503,316,40,0,40,80,30,50,134,11,123,62,3,59,3581,35364,18790,"Tishomingo County, Mississippi",141,28,18.36127775
1472,28143,Tunica County, Mississippi,32.4,10407,187,32,0,32,106,23,83,33,11,22,16,0,16,2925,31918,16950,"Tunica County, Mississippi",143,28,28.10608244
1473,28145,Union County, Mississippi,38,27989,751,129,0,129,411,13,398,151,0,151,60,33,27,5277,37898,19723,"Union County, Mississippi",145,28,18.85383544
1474,28147,Walthall County, Mississippi,40.3,14812,79,0,0,0,40,0,40,18,0,18,21,21,0,3724,30571,18255,"Walthall County, Mississippi",147,28,25.14177694
1475,28149,Warren County, Mississippi,38,47834,837,67,16,51,371,142,229,141,131,10,258,184,74,11252,40475,22110,"Warren County, Mississippi",149,28,23.5230171
1476,28151,Washington County, Mississippi,36.4,48824,527,144,21,123,126,44,82,123,67,56,134,98,36,16831,28452,17800,"Washington County, Mississippi",151,28,34.47280026
1477,28153,Wayne County, Mississippi,36.9,20517,33,0,0,0,28,0,28,0,0,0,5,0,5,5144,34458,20460,"Wayne County, Mississippi",153,28,25.0718916
1478,28155,Webster County, Mississippi,40.1,9922,55,0,0,0,11,0,11,6,0,6,38,35,3,2110,37083,20722,"Webster County, Mississippi",155,28,21.26587382
1479,28157,Wilkinson County, Mississippi,36.8,9233,0,0,0,0,0,0,0,0,0,0,0,0,0,2913,25846,14183,"Wilkinson County, Mississippi",157,28,31.54987545
1480,28159,Winston County, Mississippi,40.8,18519,80,0,0,0,68,0,68,0,0,0,12,12,0,5113,32820,21943,"Winston County, Mississippi",159,28,27.60948215
1481,28161,Yalobusha County, Mississippi,42.1,12380,51,1,0,1,3,0,3,0,0,0,47,39,8,2630,34749,18802,"Yalobusha County, Mississippi",161,28,21.24394184
1482,28163,Yazoo County, Mississippi,35.6,27719,834,80,0,80,195,0,195,273,70,203,286,53,233,8180,27560,16756,"Yazoo County, Mississippi",163,28,29.5104441
1483,29001,Adair County, Missouri,27.7,25547,839,343,74,269,175,114,61,237,202,35,84,65,19,5929,37967,19804,"Adair County, Missouri",1,29,23.20820449
1484,29003,Andrew County, Missouri,42,17347,141,19,5,14,40,16,24,24,24,0,58,49,9,1568,54804,26661,"Andrew County, Missouri",3,29,9.039026921
1485,29005,Atchison County, Missouri,47.7,5380,25,8,0,8,8,1,7,7,0,7,2,2,0,635,43438,26710,"Atchison County, Missouri",5,29,11.80297398
1486,29007,Audrain County, Missouri,40.1,25868,349,44,5,39,145,43,102,61,43,18,99,98,1,4193,41930,19692,"Audrain County, Missouri",7,29,16.20921602
1487,29009,Barry County, Missouri,43.3,35716,1875,210,11,199,533,47,486,794,295,499,338,201,137,7876,37869,19431,"Barry County, Missouri",9,29,22.05174152
1488,29011,Barton County, Missouri,40.8,12075,203,6,0,6,5,0,5,123,34,89,69,51,18,2722,38877,22513,"Barton County, Missouri",11,29,22.54244306
1489,29013,Bates County, Missouri,41.2,16513,126,8,0,8,44,17,27,25,17,8,49,42,7,2623,41520,22250,"Bates County, Missouri",13,29,15.88445467
1490,29015,Benton County, Missouri,52.9,18825,135,4,0,4,62,24,38,9,9,0,60,37,23,3581,33428,19487,"Benton County, Missouri",15,29,19.02257636
1491,29017,Bollinger County, Missouri,43.5,12282,41,0,0,0,6,6,0,1,1,0,34,28,6,2881,39493,19987,"Bollinger County, Missouri",17,29,23.45709168
1492,29019,Boone County, Missouri,30.3,172773,10799,3869,107,3762,3271,667,2604,1773,1266,507,1886,1492,394,31461,50813,27689,"Boone County, Missouri",19,29,18.20944245
1493,29021,Buchanan County, Missouri,36.9,89415,3409,1346,27,1319,1124,302,822,384,104,280,555,449,106,15652,46680,23189,"Buchanan County, Missouri",21,29,17.50489292
1494,29023,Butler County, Missouri,40.2,42887,588,57,0,57,225,77,148,168,22,146,138,105,33,9053,36302,20042,"Butler County, Missouri",23,29,21.10896076
1495,29025,Caldwell County, Missouri,42.8,9057,93,10,0,10,33,0,33,20,0,20,30,15,15,1153,44722,23273,"Caldwell County, Missouri",25,29,12.73048471
1496,29027,Callaway County, Missouri,37.8,44693,760,93,0,93,279,108,171,157,85,72,231,171,60,5354,50362,23475,"Callaway County, Missouri",27,29,11.97950462
1497,29029,Camden County, Missouri,50.1,44152,991,289,5,284,352,105,247,69,55,14,281,192,89,7943,46747,24484,"Camden County, Missouri",29,29,17.99012502
1498,29031,Cape Girardeau County, Missouri,36.2,78089,2028,884,10,874,637,267,370,260,157,103,247,161,86,13236,48458,25348,"Cape Girardeau County, Missouri",31,29,16.94989051
1499,29033,Carroll County, Missouri,42.8,9009,81,35,0,35,11,11,0,0,0,0,35,31,4,1632,41537,24484,"Carroll County, Missouri",33,29,18.11521812
1500,29035,Carter County, Missouri,40.6,6249,14,0,0,0,0,0,0,0,0,0,14,14,0,1275,37162,21296,"Carter County, Missouri",35,29,20.40326452
1501,29037,Cass County, Missouri,39.4,101324,2372,210,36,174,800,308,492,716,317,399,646,563,83,9330,63613,29197,"Cass County, Missouri",37,29,9.208084955
1502,29039,Cedar County, Missouri,44.4,13932,83,3,3,0,38,4,34,7,0,7,35,33,2,3171,33720,18932,"Cedar County, Missouri",39,29,22.76055125
1503,29041,Chariton County, Missouri,45.4,7615,29,4,0,4,1,0,1,0,0,0,24,19,5,1130,41773,23029,"Chariton County, Missouri",41,29,14.83913329
1504,29043,Christian County, Missouri,37.5,82053,1393,95,21,74,521,162,359,329,154,175,448,253,195,8935,54392,25342,"Christian County, Missouri",43,29,10.88930326
1505,29045,Clark County, Missouri,43.7,6860,29,22,0,22,0,0,0,0,0,0,7,7,0,928,45169,25149,"Clark County, Missouri",45,29,13.52769679
1506,29047,Clay County, Missouri,36.8,233135,10484,1274,207,1067,3890,1746,2144,2724,1889,835,2596,2142,454,20867,63702,30531,"Clay County, Missouri",47,29,8.950608017
1507,29049,Clinton County, Missouri,40.9,20494,317,4,0,4,74,46,28,79,28,51,160,114,46,1887,57486,26551,"Clinton County, Missouri",49,29,9.207572948
1508,29051,Cole County, Missouri,37.9,76603,2067,431,71,360,788,374,414,442,276,166,406,312,94,9067,54130,26557,"Cole County, Missouri",51,29,11.83635106
1509,29053,Cooper County, Missouri,38.8,17613,175,21,0,21,70,9,61,42,25,17,42,39,3,2137,44917,22822,"Cooper County, Missouri",53,29,12.13308352
1510,29055,Crawford County, Missouri,41.6,24545,201,0,0,0,24,0,24,76,30,46,101,56,45,5166,36983,20373,"Crawford County, Missouri",55,29,21.04705643
1511,29057,Dade County, Missouri,46.9,7590,83,17,0,17,8,6,2,28,27,1,30,26,4,1520,37904,20624,"Dade County, Missouri",57,29,20.02635046
1512,29059,Dallas County, Missouri,43.3,16508,132,0,0,0,0,0,0,41,34,7,91,91,0,2970,37695,17378,"Dallas County, Missouri",59,29,17.99127696
1513,29061,Daviess County, Missouri,40.8,8257,74,15,0,15,32,9,23,5,5,0,22,20,2,1301,43669,21356,"Daviess County, Missouri",61,29,15.75632796
1514,29063,DeKalb County, Missouri,40.4,12706,155,16,0,16,17,6,11,41,12,29,81,62,19,1296,43538,17584,"DeKalb County, Missouri",63,29,10.19990556
1515,29065,Dent County, Missouri,43.1,15578,168,47,0,47,36,17,19,13,10,3,72,38,34,3426,38020,19929,"Dent County, Missouri",65,29,21.9925536
1516,29067,Douglas County, Missouri,47.4,13467,61,0,0,0,25,4,21,4,0,4,32,11,21,2704,31333,17261,"Douglas County, Missouri",67,29,20.07871092
1517,29069,Dunklin County, Missouri,39.6,31271,835,135,54,81,333,16,317,270,58,212,97,56,41,8355,31220,18203,"Dunklin County, Missouri",69,29,26.71804547
1518,29071,Franklin County, Missouri,40.6,102063,1576,190,0,190,238,112,126,571,330,241,577,432,145,12057,50895,26272,"Franklin County, Missouri",71,29,11.81329179
1519,29073,Gasconade County, Missouri,45.7,14875,113,4,0,4,9,5,4,23,2,21,77,56,21,2074,45505,24355,"Gasconade County, Missouri",73,29,13.94285714
1520,29075,Gentry County, Missouri,41.8,6745,57,1,0,1,36,0,36,4,3,1,16,7,9,1039,44024,20726,"Gentry County, Missouri",75,29,15.40400297
1521,29077,Greene County, Missouri,35.7,285449,9353,2305,328,1977,2315,856,1459,1998,1193,805,2735,2106,629,51145,41908,24537,"Greene County, Missouri",77,29,17.91738629
1522,29079,Grundy County, Missouri,40.8,10231,163,110,2,108,6,6,0,0,0,0,47,27,20,1975,40187,20746,"Grundy County, Missouri",79,29,19.30407585
1523,29081,Harrison County, Missouri,42.5,8649,163,0,0,0,53,9,44,60,0,60,50,33,17,1564,41173,20434,"Harrison County, Missouri",81,29,18.08301538
1524,29083,Henry County, Missouri,43.8,21930,325,0,0,0,107,15,92,161,16,145,57,52,5,4575,42707,23510,"Henry County, Missouri",83,29,20.86183311
1525,29085,Hickory County, Missouri,54.2,9267,59,12,0,12,20,6,14,0,0,0,27,26,1,2295,33113,18694,"Hickory County, Missouri",85,29,24.76529621
1526,29087,Holt County, Missouri,47.8,4537,18,0,0,0,2,2,0,6,6,0,10,8,2,614,41017,23949,"Holt County, Missouri",87,29,13.5331717
1527,29089,Howard County, Missouri,38.9,10148,84,15,0,15,20,10,10,26,11,15,23,23,0,1719,45762,22192,"Howard County, Missouri",89,29,16.93929838
1528,29091,Howell County, Missouri,40.5,40265,609,85,48,37,149,44,105,134,47,87,241,93,148,8980,33964,19293,"Howell County, Missouri",91,29,22.30224761
1529,29093,Iron County, Missouri,44.1,10220,57,0,0,0,21,21,0,10,0,10,26,18,8,2124,36354,19270,"Iron County, Missouri",93,29,20.78277886
1530,29095,Jackson County, Missouri,36.5,683643,37601,5370,516,4854,12629,3606,9023,9897,4326,5571,9705,7291,2414,115709,48104,27665,"Jackson County, Missouri",95,29,16.92535432
1531,29097,Jasper County, Missouri,35.8,117376,4812,596,51,545,1499,207,1292,1629,582,1047,1088,635,453,20393,42648,22767,"Jasper County, Missouri",97,29,17.37407988
1532,29099,Jefferson County, Missouri,38.8,222453,3538,376,2,374,1106,400,706,984,757,227,1072,865,207,24089,58232,26021,"Jefferson County, Missouri",99,29,10.82880429
1533,29101,Johnson County, Missouri,29.8,54229,1450,374,23,351,673,242,431,153,70,83,250,169,81,8426,48977,22589,"Johnson County, Missouri",101,29,15.53781187
1534,29103,Knox County, Missouri,43.6,3997,41,0,0,0,3,0,3,11,6,5,27,24,3,786,38816,21471,"Knox County, Missouri",103,29,19.66474856
1535,29105,Laclede County, Missouri,40.1,35505,248,25,0,25,66,66,0,73,60,13,84,68,16,6698,40436,19552,"Laclede County, Missouri",105,29,18.8649486
1536,29107,Lafayette County, Missouri,42.1,32789,466,36,0,36,217,74,143,55,16,39,158,131,27,3912,50830,25008,"Lafayette County, Missouri",107,29,11.93083046
1537,29109,Lawrence County, Missouri,39.6,38204,1095,45,0,45,353,202,151,402,59,343,295,166,129,6803,40505,19973,"Lawrence County, Missouri",109,29,17.80703591
1538,29111,Lewis County, Missouri,39.3,10146,166,22,0,22,86,9,77,37,11,26,21,21,0,1299,45708,20646,"Lewis County, Missouri",111,29,12.8030751
1539,29113,Lincoln County, Missouri,36.7,54286,650,96,17,79,227,79,148,212,53,159,115,73,42,7358,55249,22833,"Lincoln County, Missouri",113,29,13.55413919
1540,29115,Linn County, Missouri,42.8,12319,69,28,0,28,6,0,6,5,5,0,30,30,0,2241,39286,20860,"Linn County, Missouri",115,29,18.19141164
1541,29117,Livingston County, Missouri,41.5,15057,112,31,4,27,43,11,32,8,0,8,30,30,0,2463,44266,22804,"Livingston County, Missouri",117,29,16.35784021
1542,29119,McDonald County, Missouri,37.2,22720,2063,214,2,212,864,132,732,609,193,416,376,238,138,4636,38846,18761,"McDonald County, Missouri",119,29,20.40492958
1543,29121,Macon County, Missouri,42.9,15399,118,13,0,13,31,1,30,28,27,1,46,33,13,2845,37099,19941,"Macon County, Missouri",121,29,18.47522566
1544,29123,Madison County, Missouri,42.9,12403,116,38,0,38,15,0,15,24,22,2,39,29,10,1978,36359,19009,"Madison County, Missouri",123,29,15.94775458
1545,29125,Maries County, Missouri,43.9,8987,27,0,0,0,0,0,0,13,13,0,14,11,3,1675,40542,20922,"Maries County, Missouri",125,29,18.63803271
1546,29127,Marion County, Missouri,39.4,28858,363,86,0,86,22,22,0,122,82,40,133,120,13,4734,43828,22303,"Marion County, Missouri",127,29,16.40446323
1547,29129,Mercer County, Missouri,43.9,3702,51,8,0,8,7,4,3,7,0,7,29,22,7,530,41817,20701,"Mercer County, Missouri",129,29,14.31658563
1548,29131,Miller County, Missouri,41.4,25011,299,19,0,19,87,54,33,130,124,6,63,56,7,4763,40057,22397,"Miller County, Missouri",131,29,19.04362081
1549,29133,Mississippi County, Missouri,38.5,14112,72,0,0,0,28,0,28,0,0,0,44,35,9,3752,29214,17049,"Mississippi County, Missouri",133,29,26.58730159
1550,29135,Moniteau County, Missouri,38,15840,446,35,2,33,214,10,204,91,21,70,106,75,31,1779,48974,21068,"Moniteau County, Missouri",135,29,11.23106061
1551,29137,Monroe County, Missouri,45.1,8642,47,0,0,0,12,0,12,19,11,8,16,11,5,1333,41201,21069,"Monroe County, Missouri",137,29,15.42467022
1552,29139,Montgomery County, Missouri,44,11820,76,19,0,19,3,0,3,11,4,7,43,27,16,1999,41096,21301,"Montgomery County, Missouri",139,29,16.91201354
1553,29141,Morgan County, Missouri,46.3,20182,212,1,0,1,64,7,57,42,9,33,105,82,23,4798,32807,19555,"Morgan County, Missouri",141,29,23.7736597
1554,29143,New Madrid County, Missouri,40.9,18229,89,30,0,30,24,0,24,16,0,16,19,11,8,4370,31615,19011,"New Madrid County, Missouri",143,29,23.97279061
1555,29145,Newton County, Missouri,39.6,58741,2192,130,60,70,835,103,732,754,218,536,473,267,206,8294,44474,23874,"Newton County, Missouri",145,29,14.11960981
1556,29147,Nodaway County, Missouri,28.7,23026,529,128,0,128,243,49,194,49,46,3,109,67,42,5046,39908,19378,"Nodaway County, Missouri",147,29,21.91435768
1557,29149,Oregon County, Missouri,46.5,10922,155,8,0,8,11,11,0,8,8,0,128,107,21,2809,30442,18080,"Oregon County, Missouri",149,29,25.71873283
1558,29151,Osage County, Missouri,40,13704,37,4,0,4,0,0,0,11,9,2,22,21,1,923,54119,24097,"Osage County, Missouri",151,29,6.735259778
1559,29153,Ozark County, Missouri,51,9450,30,0,0,0,0,0,0,2,0,2,28,15,13,2546,31087,16706,"Ozark County, Missouri",153,29,26.94179894
1560,29155,Pemiscot County, Missouri,37.8,17599,126,14,0,14,50,3,47,39,14,25,23,9,14,5036,31671,17681,"Pemiscot County, Missouri",155,29,28.61526223
1561,29157,Perry County, Missouri,40.2,19152,177,53,0,53,16,0,16,34,14,20,74,65,9,1487,53014,24658,"Perry County, Missouri",157,29,7.764202172
1562,29159,Pettis County, Missouri,37.5,42193,2603,265,8,257,1191,200,991,794,274,520,353,174,179,7000,40467,20643,"Pettis County, Missouri",159,29,16.59042969
1563,29161,Phelps County, Missouri,34.5,44833,2521,1081,35,1046,857,199,658,182,140,42,401,381,20,8620,41603,22400,"Phelps County, Missouri",161,29,19.22690875
1564,29163,Pike County, Missouri,38.9,18475,168,10,0,10,77,3,74,43,11,32,38,28,10,2447,42779,19900,"Pike County, Missouri",163,29,13.24492558
1565,29165,Platte County, Missouri,38.1,94970,4998,1261,115,1146,1938,1024,914,519,285,234,1280,991,289,6689,70879,36160,"Platte County, Missouri",165,29,7.043276824
1566,29167,Polk County, Missouri,37.4,31113,248,4,1,3,81,29,52,94,79,15,69,69,0,5228,42483,20553,"Polk County, Missouri",167,29,16.80326552
1567,29169,Pulaski County, Missouri,26.9,53302,2535,580,0,580,624,256,368,561,421,140,770,657,113,6372,49216,20464,"Pulaski County, Missouri",169,29,11.95452328
1568,29171,Putnam County, Missouri,46.8,4877,47,0,0,0,17,0,17,2,2,0,28,24,4,900,38125,20636,"Putnam County, Missouri",171,29,18.4539676
1569,29173,Ralls County, Missouri,44.9,10225,84,0,0,0,52,39,13,0,0,0,32,6,26,1268,48919,24099,"Ralls County, Missouri",173,29,12.400978
1570,29175,Randolph County, Missouri,39,25081,240,49,0,49,62,25,37,9,6,3,120,111,9,4025,40638,18615,"Randolph County, Missouri",175,29,16.04800447
1571,29177,Ray County, Missouri,41.6,22921,213,10,0,10,32,24,8,58,53,5,113,110,3,3619,53459,24429,"Ray County, Missouri",177,29,15.78901444
1572,29179,Reynolds County, Missouri,46.8,6530,14,0,0,0,4,0,4,6,6,0,4,2,2,1245,36736,20792,"Reynolds County, Missouri",179,29,19.06584992
1573,29181,Ripley County, Missouri,42.2,13936,74,5,0,5,8,0,8,0,0,0,61,32,29,3312,34145,17986,"Ripley County, Missouri",181,29,23.76578645
1574,29183,St. Charles County, Missouri,37.7,379856,15036,3049,171,2878,4771,1590,3181,3394,2027,1367,3822,3144,678,22765,75603,34021,"St. Charles County, Missouri",183,29,5.993060528
1575,29185,St. Clair County, Missouri,49.8,9444,103,0,0,0,31,0,31,17,0,17,55,55,0,2052,33750,19370,"St. Clair County, Missouri",185,29,21.72808132
1576,29186,Ste. Genevieve County, Missouri,42.2,17937,405,8,0,8,366,0,366,0,0,0,31,19,12,2561,49356,24013,"Ste. Genevieve County, Missouri",186,29,14.2777499
1577,29187,St. Francois County, Missouri,38.8,66230,410,60,7,53,133,31,102,88,38,50,129,40,89,9955,41461,20016,"St. Francois County, Missouri",187,29,15.03095274
1578,29189,St. Louis County, Missouri,40.3,1000560,68893,11932,944,10988,22381,7761,14620,18945,13330,5615,15635,13540,2095,100613,61103,36518,"St. Louis County, Missouri",189,29,10.05566883
1579,29195,Saline County, Missouri,37.4,23214,1186,207,0,207,379,47,332,374,174,200,226,220,6,3748,40645,20446,"Saline County, Missouri",195,29,16.14542948
1580,29197,Schuyler County, Missouri,41.3,4396,30,19,0,19,2,0,2,7,7,0,2,1,1,951,37583,19152,"Schuyler County, Missouri",197,29,21.633303
1581,29199,Scotland County, Missouri,39,4893,0,0,0,0,0,0,0,0,0,0,0,0,0,781,41336,23626,"Scotland County, Missouri",199,29,15.96157776
1582,29201,Scott County, Missouri,39.6,38994,355,43,21,22,129,13,116,47,26,21,136,128,8,7467,40276,22034,"Scott County, Missouri",201,29,19.14909986
1583,29203,Shannon County, Missouri,44.8,8256,8,0,0,0,0,0,0,4,4,0,4,0,4,1831,32284,19290,"Shannon County, Missouri",203,29,22.17781008
1584,29205,Shelby County, Missouri,42.1,6148,34,3,0,3,22,12,10,9,9,0,0,0,0,928,41351,21521,"Shelby County, Missouri",205,29,15.09433962
1585,29207,Stoddard County, Missouri,42.2,29788,131,3,0,3,50,0,50,66,46,20,12,9,3,4848,38096,21174,"Stoddard County, Missouri",207,29,16.27501007
1586,29209,Stone County, Missouri,52.1,31197,354,68,0,68,69,18,51,33,20,13,184,146,38,4139,41944,23705,"Stone County, Missouri",209,29,13.26730134
1587,29211,Sullivan County, Missouri,41.4,6416,543,42,7,35,268,119,149,105,28,77,128,53,75,1037,42639,20579,"Sullivan County, Missouri",211,29,16.1627182
1588,29213,Taney County, Missouri,41.7,53853,1915,222,1,221,976,71,905,364,181,183,353,301,52,9264,38040,20929,"Taney County, Missouri",213,29,17.20238427
1589,29215,Texas County, Missouri,41.5,25690,186,5,0,5,18,11,7,44,14,30,119,92,27,6301,35730,17367,"Texas County, Missouri",215,29,24.52705333
1590,29217,Vernon County, Missouri,40.7,20836,243,47,0,47,36,10,26,102,50,52,58,29,29,3499,40655,21246,"Vernon County, Missouri",217,29,16.79305049
1591,29219,Warren County, Missouri,40.4,33290,609,89,0,89,150,66,84,266,196,70,104,104,0,4506,51509,24870,"Warren County, Missouri",219,29,13.53559628
1592,29221,Washington County, Missouri,40.7,25002,53,0,0,0,22,0,22,17,6,11,14,9,5,4678,36701,18472,"Washington County, Missouri",221,29,18.71050316
1593,29223,Wayne County, Missouri,46.8,13341,75,11,0,11,13,0,13,0,0,0,51,50,1,3003,33954,18378,"Wayne County, Missouri",223,29,22.509557
1594,29225,Webster County, Missouri,37.6,37075,326,16,0,16,127,53,74,60,24,36,123,106,17,6737,44814,20424,"Webster County, Missouri",225,29,18.17127444
1595,29227,Worth County, Missouri,47.9,2061,12,0,0,0,0,0,0,10,10,0,2,0,2,262,44974,23292,"Worth County, Missouri",227,29,12.71227559
1596,29229,Wright County, Missouri,41.9,18378,177,4,0,4,8,8,0,72,66,6,93,71,22,4560,30581,18502,"Wright County, Missouri",229,29,24.81227555
1597,29510,St. Louis city, Missouri,34.8,316030,20045,4289,170,4119,7000,2399,4601,4922,3080,1842,3834,2794,1040,81916,36809,25434,"St. Louis city, Missouri",510,29,25.92032402
1598,30001,Beaverhead County, Montana,42.7,9317,385,52,0,52,172,51,121,94,43,51,67,41,26,1508,38194,26609,"Beaverhead County, Montana",1,30,16.18546743
1599,30003,Big Horn County, Montana,30,13214,187,35,0,35,32,2,30,59,48,11,61,8,53,3615,44136,17352,"Big Horn County, Montana",3,30,27.35734827
1600,30005,Blaine County, Montana,34,6609,88,27,10,17,2,2,0,4,4,0,55,48,7,1856,36875,17080,"Blaine County, Montana",5,30,28.08291723
1601,30007,Broadwater County, Montana,46.7,5692,152,10,10,0,80,80,0,0,0,0,62,42,20,471,50946,29598,"Broadwater County, Montana",7,30,8.274771609
1602,30009,Carbon County, Montana,49.6,10340,132,3,0,3,37,14,23,17,10,7,75,70,5,1108,52869,30461,"Carbon County, Montana",9,30,10.71566731
1603,30011,Carter County, Montana,51,1295,1,0,0,0,1,0,1,0,0,0,0,0,0,160,46985,30728,"Carter County, Montana",11,30,12.35521236
1604,30013,Cascade County, Montana,38,82049,1639,142,7,135,201,78,123,346,279,67,950,732,218,11694,45469,26578,"Cascade County, Montana",13,30,14.2524589
1605,30015,Chouteau County, Montana,41.1,5837,78,10,3,7,24,7,17,6,0,6,38,31,7,1257,38735,22247,"Chouteau County, Montana",15,30,21.53503512
1606,30017,Custer County, Montana,40.7,11980,161,19,0,19,12,5,7,20,20,0,110,63,47,1289,50146,26742,"Custer County, Montana",17,30,10.75959933
1607,30019,Daniels County, Montana,46,1787,66,6,3,3,9,0,9,1,0,1,50,50,0,84,51108,33909,"Daniels County, Montana",19,30,4.700615557
1608,30021,Dawson County, Montana,41.4,9431,128,22,0,22,6,6,0,4,0,4,96,17,79,1365,57591,28438,"Dawson County, Montana",21,30,14.47354469
1609,30023,Deer Lodge County, Montana,47.3,9176,172,4,0,4,0,0,0,36,19,17,132,129,3,1785,39212,23192,"Deer Lodge County, Montana",23,30,19.45292066
1610,30025,Fallon County, Montana,38.3,2913,39,0,0,0,0,0,0,3,3,0,36,19,17,197,50114,31902,"Fallon County, Montana",25,30,6.762787504
1611,30027,Fergus County, Montana,46.9,11429,202,29,0,29,42,0,42,41,41,0,90,19,71,1574,42357,25788,"Fergus County, Montana",27,30,13.77198355
1612,30029,Flathead County, Montana,42.1,94696,1912,172,2,170,485,233,252,310,239,71,945,745,200,12875,48407,27083,"Flathead County, Montana",29,30,13.59613922
1613,30031,Gallatin County, Montana,33.2,97958,3068,911,40,871,803,262,541,588,306,282,766,571,195,12716,57021,31909,"Gallatin County, Montana",31,30,12.98107352
1614,30033,Garfield County, Montana,45.5,1061,0,0,0,0,0,0,0,0,0,0,0,0,0,71,42614,28159,"Garfield County, Montana",33,30,6.691800189
1615,30035,Glacier County, Montana,31.1,13695,227,70,0,70,48,25,23,49,26,23,60,35,25,4502,29181,16284,"Glacier County, Montana",35,30,32.87331143
1616,30037,Golden Valley County, Montana,54.6,730,5,0,0,0,0,0,0,0,0,0,5,5,0,119,44000,25714,"Golden Valley County, Montana",37,30,16.30136986
1617,30039,Granite County, Montana,53.5,3212,44,12,0,12,0,0,0,3,3,0,29,4,25,456,48688,26720,"Granite County, Montana",39,30,14.19676214
1618,30041,Hill County, Montana,34.5,16529,187,13,0,13,17,2,15,59,51,8,98,82,16,3532,42979,21070,"Hill County, Montana",41,30,21.36850384
1619,30043,Jefferson County, Montana,47.9,11601,165,30,0,30,37,1,36,41,32,9,57,44,13,973,62939,31801,"Jefferson County, Montana",43,30,8.387207999
1620,30045,Judith Basin County, Montana,52,1981,25,2,0,2,2,0,2,3,3,0,18,18,0,249,45347,28741,"Judith Basin County, Montana",45,30,12.56940939
1621,30047,Lake County, Montana,41.5,29311,643,27,0,27,181,89,92,138,66,72,297,193,104,6206,39898,23191,"Lake County, Montana",47,30,21.17293849
1622,30049,Lewis and Clark County, Montana,41.2,65989,961,133,0,133,221,54,167,107,63,44,500,453,47,7786,59170,29892,"Lewis and Clark County, Montana",49,30,11.79893619
1623,30051,Liberty County, Montana,46.7,2292,32,0,0,0,0,0,0,0,0,0,32,32,0,349,46597,32427,"Liberty County, Montana",51,30,15.22687609
1624,30053,Lincoln County, Montana,51.4,19268,452,17,0,17,21,2,19,149,122,27,265,209,56,3410,35461,22404,"Lincoln County, Montana",53,30,17.69773718
1625,30055,McCone County, Montana,50.2,1678,6,0,0,0,0,0,0,2,0,2,4,0,4,175,42330,28736,"McCone County, Montana",55,30,10.42908224
1626,30057,Madison County, Montana,52.7,7810,239,138,0,138,48,11,37,17,10,7,36,35,1,874,47617,30030,"Madison County, Montana",57,30,11.19078105
1627,30059,Meagher County, Montana,48.6,1960,21,7,0,7,11,9,2,0,0,0,3,3,0,295,39032,19989,"Meagher County, Montana",59,30,15.05102041
1628,30061,Mineral County, Montana,52.4,4223,80,0,0,0,4,0,4,2,2,0,74,69,5,869,37143,21447,"Mineral County, Montana",61,30,20.5777883
1629,30063,Missoula County, Montana,35.3,113101,2774,642,30,612,490,83,407,418,259,159,1224,934,290,17671,46371,27956,"Missoula County, Montana",63,30,15.6240882
1630,30065,Musselshell County, Montana,48.5,4778,88,16,0,16,39,27,12,3,0,3,30,20,10,795,41557,23167,"Musselshell County, Montana",65,30,16.63876099
1631,30067,Park County, Montana,46.4,15843,343,20,0,20,84,32,52,67,40,27,172,146,26,1905,43385,27597,"Park County, Montana",67,30,12.02423783
1632,30069,Petroleum County, Montana,50.4,445,3,0,0,0,0,0,0,0,0,0,3,3,0,69,38250,26822,"Petroleum County, Montana",69,30,15.50561798
1633,30071,Phillips County, Montana,47.3,4150,36,0,0,0,8,2,6,5,5,0,23,21,2,664,38692,22772,"Phillips County, Montana",71,30,16
1634,30073,Pondera County, Montana,41.9,6166,135,37,1,36,34,17,17,12,12,0,52,46,6,1228,42193,21995,"Pondera County, Montana",73,30,19.91566656
1635,30075,Powder River County, Montana,52,1648,18,0,0,0,16,0,16,0,0,0,2,0,2,124,47955,29393,"Powder River County, Montana",75,30,7.524271845
1636,30077,Powell County, Montana,45,6928,31,3,0,3,3,3,0,1,1,0,24,20,4,555,43064,23620,"Powell County, Montana",77,30,8.010969977
1637,30079,Prairie County, Montana,51.2,1414,26,1,0,1,14,5,9,0,0,0,11,8,3,255,44643,24431,"Prairie County, Montana",79,30,18.03394625
1638,30081,Ravalli County, Montana,48.1,41130,678,6,0,6,164,149,15,161,150,11,347,252,95,7173,40546,23042,"Ravalli County, Montana",81,30,17.43982495
1639,30083,Richland County, Montana,38,11392,227,6,6,0,109,7,102,53,38,15,59,32,27,981,65638,33949,"Richland County, Montana",83,30,8.61130618
1640,30085,Roosevelt County, Montana,30.2,11230,94,25,0,25,23,0,23,16,5,11,30,30,0,2953,34481,16885,"Roosevelt County, Montana",85,30,26.29563669
1641,30087,Rosebud County, Montana,36.3,9348,119,25,0,25,7,0,7,57,32,25,30,21,9,1813,55609,23387,"Rosebud County, Montana",87,30,19.39452289
1642,30089,Sanders County, Montana,51.9,11375,296,3,0,3,45,20,25,59,57,2,189,173,16,2493,34336,20810,"Sanders County, Montana",89,30,21.91648352
1643,30091,Sheridan County, Montana,47.2,3645,57,9,0,9,9,0,9,5,4,1,34,21,13,395,52308,31997,"Sheridan County, Montana",91,30,10.83676269
1644,30093,Silver Bow County, Montana,40.7,34560,917,354,0,354,102,42,60,348,252,96,113,93,20,6555,39580,25583,"Silver Bow County, Montana",93,30,18.96701389
1645,30095,Stillwater County, Montana,46.6,9342,164,24,0,24,44,10,34,44,36,8,52,29,23,675,59603,30958,"Stillwater County, Montana",95,30,7.225433526
1646,30097,Sweet Grass County, Montana,48.1,3634,43,4,0,4,23,4,19,2,2,0,14,7,7,427,50813,26935,"Sweet Grass County, Montana",97,30,11.75013759
1647,30099,Teton County, Montana,44.6,6067,98,22,13,9,11,0,11,3,3,0,62,55,7,631,49047,25740,"Teton County, Montana",99,30,10.40052744
1648,30101,Toole County, Montana,40.7,5114,200,4,0,4,20,12,8,17,15,2,159,126,33,747,46588,23705,"Toole County, Montana",101,30,14.60696128
1649,30103,Treasure County, Montana,48.9,846,7,0,0,0,0,0,0,0,0,0,7,7,0,162,42500,21255,"Treasure County, Montana",103,30,19.14893617
1650,30105,Valley County, Montana,44.3,7576,95,24,4,20,21,0,21,17,17,0,33,13,20,711,49977,27820,"Valley County, Montana",105,30,9.384899683
1651,30107,Wheatland County, Montana,42.9,2109,32,7,0,7,18,0,18,5,5,0,2,0,2,365,36076,19407,"Wheatland County, Montana",107,30,17.30678046
1652,30109,Wibaux County, Montana,51,1143,9,0,0,0,9,0,9,0,0,0,0,0,0,143,40833,23985,"Wibaux County, Montana",109,30,12.51093613
1653,30111,Yellowstone County, Montana,38.2,155344,2925,417,116,301,718,383,335,621,392,229,1169,811,358,15767,55032,30519,"Yellowstone County, Montana",111,30,10.14973221
1654,31001,Adams County, Nebraska,37.7,31536,1803,457,16,441,429,42,387,522,330,192,395,274,121,3314,51201,27609,"Adams County, Nebraska",1,31,10.50862506
1655,31003,Antelope County, Nebraska,46.1,6421,133,31,0,31,63,19,44,23,16,7,16,16,0,748,46381,27048,"Antelope County, Nebraska",3,31,11.64927581
1656,31005,Arthur County, Nebraska,41,437,1,1,0,1,0,0,0,0,0,0,0,0,0,35,40375,21174,"Arthur County, Nebraska",5,31,8.009153318
1657,31007,Banner County, Nebraska,47.9,793,15,11,0,11,1,0,1,0,0,0,3,3,0,95,50833,30095,"Banner County, Nebraska",7,31,11.97982346
1658,31009,Blaine County, Nebraska,43.6,580,8,0,0,0,0,0,0,8,8,0,0,0,0,94,50350,23001,"Blaine County, Nebraska",9,31,16.20689655
1659,31011,Boone County, Nebraska,45.4,5353,47,16,0,16,12,0,12,2,0,2,17,17,0,394,51890,28288,"Boone County, Nebraska",11,31,7.360358677
1660,31013,Box Butte County, Nebraska,40.5,11279,232,55,0,55,62,12,50,56,0,56,59,51,8,1544,54444,27751,"Box Butte County, Nebraska",13,31,13.68915684
1661,31015,Boyd County, Nebraska,51.4,2006,11,2,0,2,2,2,0,5,0,5,2,2,0,246,42463,25507,"Boyd County, Nebraska",15,31,12.26321037
1662,31017,Brown County, Nebraska,47.7,3022,5,1,0,1,4,4,0,0,0,0,0,0,0,512,37328,30135,"Brown County, Nebraska",17,31,16.94242224
1663,31019,Buffalo County, Nebraska,32.6,48402,1972,512,3,509,600,56,544,479,231,248,381,254,127,6252,54098,27218,"Buffalo County, Nebraska",19,31,12.91682162
1664,31021,Burt County, Nebraska,47.4,6594,91,0,0,0,9,4,5,26,5,21,56,26,30,647,47137,24613,"Burt County, Nebraska",21,31,9.811950258
1665,31023,Butler County, Nebraska,44.1,8205,153,18,6,12,78,11,67,19,19,0,38,23,15,697,51166,28045,"Butler County, Nebraska",23,31,8.494820232
1666,31025,Cass County, Nebraska,42,25463,315,22,0,22,97,58,39,65,31,34,131,85,46,1764,65385,30637,"Cass County, Nebraska",25,31,6.927699014
1667,31027,Cedar County, Nebraska,44.5,8657,29,0,0,0,3,3,0,7,7,0,19,15,4,881,54391,28663,"Cedar County, Nebraska",27,31,10.17673559
1668,31029,Chase County, Nebraska,43.3,4061,376,94,0,94,233,0,233,39,0,39,10,10,0,387,53496,29239,"Chase County, Nebraska",29,31,9.529672494
1669,31031,Cherry County, Nebraska,43.7,5781,165,18,17,1,25,2,23,81,9,72,41,40,1,458,53059,27891,"Cherry County, Nebraska",31,31,7.922504757
1670,31033,Cheyenne County, Nebraska,40.5,10090,202,2,2,0,46,0,46,78,0,78,76,67,9,996,54215,30929,"Cheyenne County, Nebraska",33,31,9.871159564
1671,31035,Clay County, Nebraska,43.6,6313,272,14,0,14,144,37,107,72,28,44,42,15,27,615,51613,25472,"Clay County, Nebraska",35,31,9.741802629
1672,31037,Colfax County, Nebraska,33.9,10499,2818,686,145,541,795,136,659,962,315,647,375,170,205,1227,52712,23619,"Colfax County, Nebraska",37,31,11.68682732
1673,31039,Cuming County, Nebraska,44,9055,411,18,0,18,276,32,244,63,16,47,54,20,34,1102,49181,26061,"Cuming County, Nebraska",39,31,12.17007178
1674,31041,Custer County, Nebraska,43.7,10784,245,7,0,7,114,54,60,80,19,61,44,35,9,1152,47083,29986,"Custer County, Nebraska",41,31,10.68249258
1675,31043,Dakota County, Nebraska,34.1,20697,4655,307,30,277,2059,446,1613,907,510,397,1382,1033,349,3273,52336,21710,"Dakota County, Nebraska",43,31,15.81388607
1676,31045,Dawes County, Nebraska,34.1,9082,311,93,0,93,112,32,80,68,10,58,38,18,20,1272,42685,23307,"Dawes County, Nebraska",45,31,14.00572561
1677,31047,Dawson County, Nebraska,36.3,23924,4116,529,94,435,1542,420,1122,1111,630,481,934,627,307,3585,49943,24042,"Dawson County, Nebraska",47,31,14.98495235
1678,31049,Deuel County, Nebraska,47.4,1932,34,6,0,6,13,0,13,8,8,0,7,5,2,198,51786,28640,"Deuel County, Nebraska",49,31,10.2484472
1679,31051,Dixon County, Nebraska,42.4,5809,339,66,0,66,45,3,42,131,95,36,97,43,54,675,52813,24983,"Dixon County, Nebraska",51,31,11.61990015
1680,31053,Dodge County, Nebraska,39.1,36679,2249,286,4,282,951,73,878,759,169,590,253,202,51,4192,49830,26141,"Dodge County, Nebraska",53,31,11.42888301
1681,31055,Douglas County, Nebraska,34.1,543253,49957,9549,632,8917,20065,4086,15979,11376,4481,6895,8967,6209,2758,75422,56003,30548,"Douglas County, Nebraska",55,31,13.88340239
1682,31057,Dundy County, Nebraska,48.3,1823,48,1,0,1,20,0,20,25,0,25,2,2,0,151,44583,28161,"Dundy County, Nebraska",57,31,8.283049918
1683,31059,Fillmore County, Nebraska,47.5,5676,77,0,0,0,4,1,3,29,29,0,44,40,4,551,52070,29361,"Fillmore County, Nebraska",59,31,9.707540521
1684,31061,Franklin County, Nebraska,50.2,3076,33,0,0,0,11,1,10,8,8,0,14,7,7,392,46531,28373,"Franklin County, Nebraska",61,31,12.74382315
1685,31063,Frontier County, Nebraska,44.9,2599,28,3,0,3,9,6,3,3,3,0,13,4,9,269,51192,26798,"Frontier County, Nebraska",63,31,10.35013467
1686,31065,Furnas County, Nebraska,46.2,4850,50,2,0,2,27,14,13,15,8,7,6,6,0,739,40445,23307,"Furnas County, Nebraska",65,31,15.2371134
1687,31067,Gage County, Nebraska,44.8,21778,253,0,0,0,93,37,56,18,18,0,142,142,0,2235,48731,26347,"Gage County, Nebraska",67,31,10.26265038
1688,31069,Garden County, Nebraska,50.2,1930,69,0,0,0,0,0,0,26,0,26,43,11,32,218,49805,30900,"Garden County, Nebraska",69,31,11.29533679
1689,31071,Garfield County, Nebraska,51,1968,4,0,0,0,0,0,0,0,0,0,4,4,0,140,45227,24379,"Garfield County, Nebraska",71,31,7.113821138
1690,31073,Gosper County, Nebraska,46.9,1977,19,0,0,0,11,11,0,2,2,0,6,6,0,112,60711,29393,"Gosper County, Nebraska",73,31,5.665149216
1691,31075,Grant County, Nebraska,50.9,647,4,0,0,0,0,0,0,0,0,0,4,4,0,103,45625,21925,"Grant County, Nebraska",75,31,15.91962906
1692,31077,Greeley County, Nebraska,45.8,2447,24,2,0,2,5,5,0,4,0,4,13,12,1,211,48220,25054,"Greeley County, Nebraska",77,31,8.622803433
1693,31079,Hall County, Nebraska,35.7,61105,8825,1424,91,1333,3210,573,2637,2348,682,1666,1843,1029,814,8894,51355,24617,"Hall County, Nebraska",79,31,14.55527371
1694,31081,Hamilton County, Nebraska,42.5,9118,113,4,0,4,26,26,0,59,51,8,24,14,10,804,59760,31565,"Hamilton County, Nebraska",81,31,8.817723185
1695,31083,Harlan County, Nebraska,49.8,3465,31,4,0,4,12,1,11,3,0,3,12,10,2,542,44630,25997,"Harlan County, Nebraska",83,31,15.64213564
1696,31085,Hayes County, Nebraska,47.7,1013,46,8,0,8,21,0,21,5,2,3,12,12,0,80,44602,27080,"Hayes County, Nebraska",85,31,7.89733465
1697,31087,Hitchcock County, Nebraska,48,2866,8,0,0,0,8,0,8,0,0,0,0,0,0,452,41131,23967,"Hitchcock County, Nebraska",87,31,15.77110956
1698,31089,Holt County, Nebraska,45.3,10360,222,26,0,26,68,7,61,60,47,13,68,68,0,990,49607,26267,"Holt County, Nebraska",89,31,9.555984556
1699,31091,Hooker County, Nebraska,59.5,669,6,0,0,0,3,3,0,0,0,0,3,3,0,104,38616,22094,"Hooker County, Nebraska",91,31,15.54559043
1700,31093,Howard County, Nebraska,43.3,6365,72,14,0,14,8,3,5,41,15,26,9,6,3,603,52247,28301,"Howard County, Nebraska",93,31,9.473684211
1701,31095,Jefferson County, Nebraska,45.7,7354,51,17,0,17,13,3,10,3,0,3,18,11,7,846,44616,26305,"Jefferson County, Nebraska",95,31,11.50394343
1702,31097,Johnson County, Nebraska,42.1,5167,223,15,0,15,36,6,30,76,8,68,96,57,39,505,47938,21890,"Johnson County, Nebraska",97,31,9.773562996
1703,31099,Kearney County, Nebraska,40.1,6548,144,5,0,5,14,0,14,18,0,18,107,27,80,443,55068,31563,"Kearney County, Nebraska",99,31,6.765424557
1704,31101,Keith County, Nebraska,48.7,8103,181,4,0,4,56,19,37,30,16,14,91,76,15,1023,43100,26699,"Keith County, Nebraska",101,31,12.62495372
1705,31103,Keya Paha County, Nebraska,52.5,736,8,2,0,2,0,0,0,0,0,0,6,6,0,77,43333,28086,"Keya Paha County, Nebraska",103,31,10.46195652
1706,31105,Kimball County, Nebraska,46.6,3713,66,5,0,5,14,1,13,21,3,18,26,26,0,377,40344,23727,"Kimball County, Nebraska",105,31,10.15351468
1707,31107,Knox County, Nebraska,47.3,8551,100,14,0,14,17,6,11,11,5,6,58,58,0,1036,47692,26675,"Knox County, Nebraska",107,31,12.11554204
1708,31109,Lancaster County, Nebraska,33,301707,22700,6421,226,6195,6434,2519,3915,6400,4532,1868,3445,2658,787,41105,53730,28600,"Lancaster County, Nebraska",109,31,13.62414528
1709,31111,Lincoln County, Nebraska,40.2,35777,615,98,0,98,194,8,186,79,36,43,244,202,42,4200,52179,27474,"Lincoln County, Nebraska",111,31,11.73938564
1710,31113,Logan County, Nebraska,43.3,830,4,4,4,0,0,0,0,0,0,0,0,0,0,95,51346,24693,"Logan County, Nebraska",113,31,11.44578313
1711,31115,Loup County, Nebraska,51,542,0,0,0,0,0,0,0,0,0,0,0,0,0,54,56750,28063,"Loup County, Nebraska",115,31,9.963099631
1712,31117,McPherson County, Nebraska,48,425,0,0,0,0,0,0,0,0,0,0,0,0,0,78,53750,25352,"McPherson County, Nebraska",117,31,18.35294118
1713,31119,Madison County, Nebraska,36.8,35125,2383,394,15,379,718,171,547,663,260,403,608,254,354,5071,48673,24458,"Madison County, Nebraska",119,31,14.43701068
1714,31121,Merrick County, Nebraska,43.8,7793,134,0,0,0,19,1,18,22,0,22,93,8,85,753,50464,26102,"Merrick County, Nebraska",121,31,9.662517644
1715,31123,Morrill County, Nebraska,41.6,4843,187,23,0,23,46,8,38,79,4,75,39,26,13,576,43942,24216,"Morrill County, Nebraska",123,31,11.89345447
1716,31125,Nance County, Nebraska,45.8,3607,28,4,0,4,0,0,0,4,4,0,20,5,15,436,42429,26179,"Nance County, Nebraska",125,31,12.08760743
1717,31127,Nemaha County, Nebraska,37.8,7101,63,13,4,9,11,2,9,17,5,12,22,19,3,713,52736,28690,"Nemaha County, Nebraska",127,31,10.04083932
1718,31129,Nuckolls County, Nebraska,49,4352,61,10,0,10,11,0,11,34,17,17,6,6,0,538,41576,24096,"Nuckolls County, Nebraska",129,31,12.36213235
1719,31131,Otoe County, Nebraska,41.8,15890,616,112,0,112,321,93,228,58,1,57,125,91,34,1676,52108,27251,"Otoe County, Nebraska",131,31,10.54751416
1720,31133,Pawnee County, Nebraska,49.5,2695,24,0,0,0,3,2,1,0,0,0,21,9,12,538,40139,27039,"Pawnee County, Nebraska",133,31,19.96289425
1721,31135,Perkins County, Nebraska,43.9,2911,88,17,0,17,44,26,18,8,8,0,19,15,4,194,56797,30429,"Perkins County, Nebraska",135,31,6.664376503
1722,31137,Phelps County, Nebraska,41.7,9236,236,30,0,30,100,4,96,89,0,89,17,17,0,740,51264,27882,"Phelps County, Nebraska",137,31,8.012126462
1723,31139,Pierce County, Nebraska,41.7,7179,56,4,0,4,8,7,1,21,21,0,23,8,15,460,53125,27386,"Pierce County, Nebraska",139,31,6.407577657
1724,31141,Platte County, Nebraska,38.4,32703,2873,427,67,360,1259,160,1099,761,242,519,426,298,128,2803,58473,27052,"Platte County, Nebraska",141,31,8.571079106
1725,31143,Polk County, Nebraska,45.6,5242,148,45,1,44,61,0,61,35,22,13,7,5,2,418,57991,30947,"Polk County, Nebraska",143,31,7.974055704
1726,31145,Red Willow County, Nebraska,41.5,10884,223,76,29,47,18,3,15,87,0,87,42,42,0,1234,42457,24529,"Red Willow County, Nebraska",145,31,11.33774348
1727,31147,Richardson County, Nebraska,47.4,8149,20,0,0,0,9,9,0,2,2,0,9,8,1,1439,45929,26638,"Richardson County, Nebraska",147,31,17.65860842
1728,31149,Rock County, Nebraska,52.4,1407,9,0,0,0,3,3,0,0,0,0,6,3,3,141,48750,30247,"Rock County, Nebraska",149,31,10.02132196
1729,31151,Saline County, Nebraska,36.6,14356,1917,255,0,255,873,149,724,470,235,235,319,232,87,1586,49332,21880,"Saline County, Nebraska",151,31,11.04764558
1730,31153,Sarpy County, Nebraska,33.9,172460,8975,1598,54,1544,2612,743,1869,1950,1017,933,2815,2391,424,10597,72269,31906,"Sarpy County, Nebraska",153,31,6.144613244
1731,31155,Saunders County, Nebraska,41.1,20946,225,30,0,30,38,23,15,83,41,42,74,46,28,1897,64475,30348,"Saunders County, Nebraska",155,31,9.056621789
1732,31157,Scotts Bluff County, Nebraska,39.6,36599,1710,289,28,261,469,116,353,427,166,261,525,359,166,4791,46632,25863,"Scotts Bluff County, Nebraska",157,31,13.0905216
1733,31159,Seward County, Nebraska,38.1,17113,318,54,7,47,118,67,51,73,54,19,73,54,19,1413,61563,28491,"Seward County, Nebraska",159,31,8.256880734
1734,31161,Sheridan County, Nebraska,45.9,5259,53,0,0,0,22,15,7,4,4,0,27,18,9,870,42802,25077,"Sheridan County, Nebraska",161,31,16.54306902
1735,31163,Sherman County, Nebraska,49.7,3090,19,1,0,1,3,3,0,4,0,4,11,7,4,402,46299,26348,"Sherman County, Nebraska",163,31,13.00970874
1736,31165,Sioux County, Nebraska,47.4,1274,26,0,0,0,5,0,5,8,5,3,13,13,0,140,46667,27279,"Sioux County, Nebraska",165,31,10.98901099
1737,31167,Stanton County, Nebraska,41.1,6022,152,14,4,10,20,1,19,94,80,14,24,24,0,570,58553,29282,"Stanton County, Nebraska",167,31,9.465293922
1738,31169,Thayer County, Nebraska,48.3,5163,46,3,0,3,8,1,7,23,23,0,12,3,9,603,45590,30057,"Thayer County, Nebraska",169,31,11.67925625
1739,31171,Thomas County, Nebraska,41.9,675,22,10,0,10,0,0,0,12,12,0,0,0,0,65,54286,30746,"Thomas County, Nebraska",171,31,9.62962963
1740,31173,Thurston County, Nebraska,28.4,6989,113,27,2,25,27,2,25,27,1,26,32,15,17,2168,42979,19100,"Thurston County, Nebraska",173,31,31.02017456
1741,31175,Valley County, Nebraska,46.1,4240,68,54,39,15,3,2,1,6,0,6,5,5,0,533,44657,26384,"Valley County, Nebraska",175,31,12.57075472
1742,31177,Washington County, Nebraska,41.2,20338,213,93,39,54,35,0,35,4,0,4,81,40,41,1834,65565,31776,"Washington County, Nebraska",177,31,9.017602517
1743,31179,Wayne County, Nebraska,30.7,9414,243,27,26,1,112,22,90,48,4,44,56,30,26,990,55141,26732,"Wayne County, Nebraska",179,31,10.51625239
1744,31181,Webster County, Nebraska,47.6,3665,57,0,0,0,2,0,2,16,12,4,39,39,0,367,40313,24534,"Webster County, Nebraska",181,31,10.01364256
1745,31183,Wheeler County, Nebraska,50,805,0,0,0,0,0,0,0,0,0,0,0,0,0,41,47452,30800,"Wheeler County, Nebraska",183,31,5.093167702
1746,31185,York County, Nebraska,40.1,13842,238,35,15,20,94,9,85,42,0,42,67,67,0,1218,55156,27962,"York County, Nebraska",185,31,8.799306459
1747,32001,Churchill County, Nevada,38.8,24148,1480,169,13,156,620,50,570,271,68,203,420,384,36,3851,45368,23951,"Churchill County, Nevada",1,32,15.94749048
1748,32003,Clark County, Nevada,36.7,2070153,455832,42148,4325,37823,131207,39146,92061,115783,53464,62319,166694,118052,48642,307146,52629,26661,"Clark County, Nevada",3,32,14.83687438
1749,32005,Douglas County, Nevada,50.1,47426,3519,158,23,135,869,206,663,536,185,351,1956,1438,518,5148,59769,35243,"Douglas County, Nevada",5,32,10.85480538
1750,32007,Elko County, Nevada,33.5,52029,4476,308,15,293,1051,198,853,1334,390,944,1783,968,815,5401,74672,31378,"Elko County, Nevada",7,32,10.3807492
1751,32009,Esmeralda County, Nevada,42,1069,114,12,0,12,41,0,41,14,14,0,47,37,10,126,43125,22415,"Esmeralda County, Nevada",9,32,11.78671656
1752,32011,Eureka County, Nevada,47.1,1730,6,0,0,0,5,5,0,0,0,0,1,0,1,186,70000,34031,"Eureka County, Nevada",11,32,10.75144509
1753,32013,Humboldt County, Nevada,35.2,17091,1773,204,58,146,370,55,315,556,206,350,643,461,182,1997,67295,27580,"Humboldt County, Nevada",13,32,11.68451232
1754,32015,Lander County, Nevada,37,5907,724,58,0,58,107,41,66,44,24,20,515,365,150,757,78077,30044,"Lander County, Nevada",15,32,12.81530388
1755,32017,Lincoln County, Nevada,39.6,5155,171,0,0,0,113,13,100,22,10,12,36,36,0,595,49406,25505,"Lincoln County, Nevada",17,32,11.54219205
1756,32019,Lyon County, Nevada,43.7,51897,3768,101,37,64,816,187,629,1168,302,866,1683,856,827,7876,49007,23519,"Lyon County, Nevada",19,32,15.17621442
1757,32021,Mineral County, Nevada,49.2,4519,191,44,0,44,41,12,29,35,18,17,71,32,39,941,37750,24146,"Mineral County, Nevada",21,32,20.82319097
1758,32023,Nye County, Nevada,51.2,43198,3054,177,61,116,706,215,491,690,130,560,1481,986,495,7346,42266,23075,"Nye County, Nevada",23,32,17.00541692
1759,32027,Pershing County, Nevada,41.3,6690,769,4,0,4,240,13,227,164,87,77,361,205,156,767,45192,17631,"Pershing County, Nevada",27,32,11.46487294
1760,32029,Storey County, Nevada,54.4,3941,123,0,0,0,42,42,0,10,0,10,71,38,33,284,65508,34967,"Storey County, Nevada",29,32,7.206292819
1761,32031,Washoe County, Nevada,37.9,439914,64947,4843,456,4387,18654,4921,13733,17854,7741,10113,23596,16263,7333,65024,54955,29942,"Washoe County, Nevada",31,32,14.78107085
1762,32033,White Pine County, Nevada,39.1,9893,356,0,0,0,134,21,113,84,9,75,138,43,95,1068,58156,24186,"White Pine County, Nevada",33,32,10.79551198
1763,32510,Carson City, Nevada,43.1,54412,6393,301,52,249,1895,276,1619,2083,1155,928,2114,1256,858,8744,47948,26553,"Carson City, Nevada",510,32,16.06998456
1764,33001,Belknap County, New Hampshire,46.5,60392,1934,166,0,166,417,217,200,587,520,67,764,578,186,6124,61245,32501,"Belknap County, New Hampshire",1,33,10.14041595
1765,33003,Carroll County, New Hampshire,50.9,47416,1508,116,0,116,361,76,285,198,143,55,833,597,236,4716,56289,33481,"Carroll County, New Hampshire",3,33,9.946009786
1766,33005,Cheshire County, New Hampshire,42.2,76320,2311,435,46,389,473,260,213,364,245,119,1039,736,303,7813,58359,30935,"Cheshire County, New Hampshire",5,33,10.23715933
1767,33007,Coos County, New Hampshire,47.9,32219,1036,16,0,16,141,30,111,148,116,32,731,530,201,4042,45154,25467,"Coos County, New Hampshire",7,33,12.54539247
1768,33009,Grafton County, New Hampshire,42.4,89164,5140,924,3,921,1437,423,1014,1266,811,455,1513,1292,221,9687,58107,33964,"Grafton County, New Hampshire",9,33,10.86425015
1769,33011,Hillsborough County, New Hampshire,40.3,404948,36959,5817,321,5496,10948,4142,6806,8247,5456,2791,11947,9368,2579,34231,73189,36012,"Hillsborough County, New Hampshire",11,33,8.453184113
1770,33013,Merrimack County, New Hampshire,42.7,147715,6582,1685,135,1550,1606,770,836,1134,589,545,2157,1743,414,12150,67181,32848,"Merrimack County, New Hampshire",13,33,8.225298717
1771,33015,Rockingham County, New Hampshire,43.8,300365,14042,1714,128,1586,3562,1787,1775,2543,1624,919,6223,4840,1383,15240,82398,41449,"Rockingham County, New Hampshire",15,33,5.073826844
1772,33017,Strafford County, New Hampshire,37.1,125913,6568,1529,12,1517,2087,578,1509,1035,667,368,1917,1447,470,11875,63533,30598,"Strafford County, New Hampshire",17,33,9.431115135
1773,33019,Sullivan County, New Hampshire,45.8,43051,983,92,45,47,211,169,42,158,123,35,522,406,116,3812,58454,30552,"Sullivan County, New Hampshire",19,33,8.854614295
1774,34001,Atlantic County, New Jersey,40.8,274026,45651,4943,629,4314,15417,6158,9259,11802,7408,4394,13489,10958,2531,41469,55456,28575,"Atlantic County, New Jersey",1,34,15.13323553
1775,34003,Bergen County, New Jersey,41.5,930310,282397,27965,2532,25433,71334,23547,47787,68767,47573,21194,114331,99480,14851,69119,88487,44978,"Bergen County, New Jersey",3,34,7.42967398
1776,34005,Burlington County, New Jersey,41.3,450236,41472,3744,438,3306,11059,4543,6516,9229,6846,2383,17440,14496,2944,28440,80034,38137,"Burlington County, New Jersey",5,34,6.316687248
1777,34007,Camden County, New Jersey,38.4,511145,56286,7139,677,6462,16466,5997,10469,14381,9504,4877,18300,14964,3336,66882,63028,31736,"Camden County, New Jersey",7,34,13.08474112
1778,34009,Cape May County, New Jersey,48.4,95404,4736,513,54,459,1488,387,1101,982,527,455,1753,1417,336,9695,59338,34550,"Cape May County, New Jersey",9,34,10.16204771
1779,34011,Cumberland County, New Jersey,36.7,155744,16575,1416,85,1331,7082,1110,5972,3940,1112,2828,4137,2969,1168,26448,49537,22303,"Cumberland County, New Jersey",11,34,16.98171358
1780,34013,Essex County, New Jersey,37,792586,198816,25090,2478,22612,60206,19700,40506,49201,28811,20390,64319,52222,12097,132940,54860,33482,"Essex County, New Jersey",13,34,16.77294325
1781,34015,Gloucester County, New Jersey,39.8,291286,15799,1687,292,1395,4039,1751,2288,3724,2483,1241,6349,5262,1087,23257,78592,34886,"Gloucester County, New Jersey",15,34,7.984249157
1782,34017,Hudson County, New Jersey,34.7,668526,285295,50795,3205,47590,86527,23933,62594,66066,38224,27842,81907,67366,14541,115156,60894,34468,"Hudson County, New Jersey",17,34,17.22535848
1783,34019,Hunterdon County, New Jersey,45.5,125708,11286,852,81,771,2723,857,1866,2551,1426,1125,5160,4239,921,5499,108177,53222,"Hunterdon County, New Jersey",19,34,4.374423267
1784,34021,Mercer County, New Jersey,38.5,371101,80951,13448,586,12862,25178,6600,18578,21423,12952,8471,20902,17069,3833,39606,73966,38652,"Mercer County, New Jersey",21,34,10.67256623
1785,34023,Middlesex County, New Jersey,37.9,831852,266813,37818,2350,35468,85465,27018,58447,69855,46479,23376,73675,63927,9748,71749,80716,35209,"Middlesex County, New Jersey",23,34,8.625212177
1786,34025,Monmouth County, New Jersey,42.6,627532,84519,6156,561,5595,23550,6148,17402,21135,13205,7930,33678,29355,4323,47318,87297,44504,"Monmouth County, New Jersey",25,34,7.540332605
1787,34027,Morris County, New Jersey,42.2,498215,94085,9337,633,8704,26587,9371,17216,22926,14161,8765,35235,31393,3842,22483,102798,51182,"Morris County, New Jersey",27,34,4.512710376
1788,34029,Ocean County, New Jersey,42.8,586166,46682,3629,322,3307,13518,3530,9988,9399,5001,4398,20136,17267,2869,64770,63108,31903,"Ocean County, New Jersey",29,34,11.04977088
1789,34031,Passaic County, New Jersey,36.5,507204,144396,16157,2136,14021,39281,14417,24864,37570,21653,15917,51388,41923,9465,83738,61664,28661,"Passaic County, New Jersey",31,34,16.50972784
1790,34033,Salem County, New Jersey,41.8,64504,3044,272,26,246,1299,222,1077,453,191,262,1020,786,234,8692,61341,30295,"Salem County, New Jersey",33,34,13.47513333
1791,34035,Somerset County, New Jersey,41.1,331686,79429,8762,849,7913,22128,7605,14523,21967,14686,7281,26572,23062,3510,16924,102405,50034,"Somerset County, New Jersey",35,34,5.102416141
1792,34037,Sussex County, New Jersey,43.8,144694,11311,438,104,334,2666,1090,1576,2484,1916,568,5723,4910,813,8358,87388,39667,"Sussex County, New Jersey",37,34,5.776327975
1793,34039,Union County, New Jersey,38.2,550436,163408,18314,1604,16710,49703,13432,36271,39552,21689,17863,55839,45188,10651,58464,70476,36374,"Union County, New Jersey",39,34,10.62139831
1794,34041,Warren County, New Jersey,43.1,107095,10387,1034,95,939,3093,995,2098,2621,1856,765,3639,2993,646,8334,72999,35386,"Warren County, New Jersey",41,34,7.781875905
1795,35001,Bernalillo County, New Mexico,36.8,674777,70983,7530,596,6934,23121,4633,18488,17028,6226,10802,23304,15232,8072,124678,48994,27402,"Bernalillo County, New Mexico",1,35,18.47691904
1796,35003,Catron County, New Mexico,58.1,3547,89,1,0,1,1,0,1,0,0,0,87,87,0,809,38142,20762,"Catron County, New Mexico",3,35,22.80800677
1797,35005,Chaves County, New Mexico,35.1,65610,8617,852,127,725,2049,420,1629,1684,439,1245,4032,2300,1732,14196,41356,21015,"Chaves County, New Mexico",5,35,21.63694559
1798,35006,Cibola County, New Mexico,35.8,27373,1813,148,0,148,420,0,420,534,73,461,711,404,307,7005,36160,16885,"Cibola County, New Mexico",6,35,25.59091075
1799,35007,Colfax County, New Mexico,48.3,12716,453,60,10,50,96,21,75,115,49,66,182,88,94,2620,32693,20911,"Colfax County, New Mexico",7,35,20.60396351
1800,35009,Curry County, New Mexico,30.8,50544,4260,518,105,413,1476,167,1309,1128,332,796,1138,750,388,10676,42170,21502,"Curry County, New Mexico",9,35,21.12219057
1801,35011,De Baca County, New Mexico,49.7,1977,80,15,0,15,24,6,18,5,5,0,36,10,26,389,31197,28232,"De Baca County, New Mexico",11,35,19.67627719
1802,35013,Do?a Ana County, New Mexico,32.6,213825,35617,2866,39,2827,7852,998,6854,8624,2509,6115,16275,8644,7631,57626,38636,20143,"Do?a Ana County, New Mexico",13,35,26.950076
1803,35015,Eddy County, New Mexico,36.4,56369,3428,609,0,609,613,129,484,616,138,478,1590,1015,575,7638,59625,27974,"Eddy County, New Mexico",15,35,13.55000089
1804,35017,Grant County, New Mexico,46.4,28879,1095,59,0,59,110,52,58,228,122,106,698,480,218,6086,38890,24882,"Grant County, New Mexico",17,35,21.07413692
1805,35019,Guadalupe County, New Mexico,41.1,4469,86,0,0,0,29,0,29,7,1,6,50,36,14,542,26692,16034,"Guadalupe County, New Mexico",19,35,12.12799284
1806,35021,Harding County, New Mexico,58,565,1,0,0,0,0,0,0,0,0,0,1,1,0,81,32404,23339,"Harding County, New Mexico",21,35,14.33628319
1807,35023,Hidalgo County, New Mexico,42.3,4531,402,8,0,8,11,4,7,95,18,77,288,168,120,1075,34528,18077,"Hidalgo County, New Mexico",23,35,23.72544692
1808,35025,Lea County, New Mexico,31.8,68930,11113,885,101,784,3245,449,2796,2806,725,2081,4177,1718,2459,10549,58152,24126,"Lea County, New Mexico",25,35,15.30393152
1809,35027,Lincoln County, New Mexico,50.9,19726,1708,189,0,189,334,56,278,608,297,311,577,484,93,3515,40065,25230,"Lincoln County, New Mexico",27,35,17.81912197
1810,35028,Los Alamos County, New Mexico,43.5,17895,1748,246,0,246,557,241,316,416,337,79,529,501,28,904,105902,51066,"Los Alamos County, New Mexico",28,35,5.051690416
1811,35029,Luna County, New Mexico,38.4,24627,4097,316,37,279,530,19,511,1108,235,873,2143,778,1365,7153,27326,15650,"Luna County, New Mexico",29,35,29.04535672
1812,35031,McKinley County, New Mexico,30.8,74346,1622,131,12,119,586,300,286,118,23,95,787,580,207,28089,29272,12882,"McKinley County, New Mexico",31,35,37.78145428
1813,35033,Mora County, New Mexico,41.3,4598,35,0,0,0,0,0,0,0,0,0,35,35,0,1036,21190,13826,"Mora County, New Mexico",33,35,22.53153545
1814,35035,Otero County, New Mexico,35.7,65333,7810,2018,68,1950,1459,328,1131,1515,435,1080,2818,1632,1186,15439,41502,20652,"Otero County, New Mexico",35,35,23.63124302
1815,35037,Quay County, New Mexico,46.5,8555,251,85,0,85,18,3,15,45,43,2,103,60,43,1638,28159,18285,"Quay County, New Mexico",37,35,19.14669784
1816,35039,Rio Arriba County, New Mexico,39.8,39924,2083,205,0,205,518,71,447,577,115,462,783,450,333,9275,33972,19600,"Rio Arriba County, New Mexico",39,35,23.23164012
1817,35041,Roosevelt County, New Mexico,29.7,19618,2143,330,0,330,601,0,601,450,146,304,762,440,322,4755,34933,18447,"Roosevelt County, New Mexico",41,35,24.23794474
1818,35043,Sandoval County, New Mexico,39.4,138117,7484,327,76,251,2034,551,1483,1772,982,790,3351,2884,467,19739,60158,27060,"Sandoval County, New Mexico",43,35,14.29150648
1819,35045,San Juan County, New Mexico,34.8,122537,4293,347,23,324,1436,114,1322,1294,437,857,1216,670,546,24871,48624,22927,"San Juan County, New Mexico",45,35,20.2967267
1820,35047,San Miguel County, New Mexico,42.2,28350,962,314,0,314,170,36,134,292,39,253,186,128,58,8093,27000,16990,"San Miguel County, New Mexico",47,35,28.54673721
1821,35049,Santa Fe County, New Mexico,45,147320,18325,1281,96,1185,7434,1117,6317,4611,1178,3433,4999,3131,1868,22507,55370,34176,"Santa Fe County, New Mexico",49,35,15.27762693
1822,35051,Sierra County, New Mexico,56,11442,457,26,0,26,60,18,42,94,39,55,277,155,122,2471,29679,20495,"Sierra County, New Mexico",51,35,21.59587485
1823,35053,Socorro County, New Mexico,35.8,17324,862,141,0,141,139,66,73,378,118,260,204,126,78,3796,34542,17277,"Socorro County, New Mexico",53,35,21.91179866
1824,35055,Taos County, New Mexico,47.6,32961,2122,152,0,152,666,125,541,381,95,286,923,782,141,7168,35323,22302,"Taos County, New Mexico",55,35,21.74691302
1825,35057,Torrance County, New Mexico,43.7,15599,848,274,0,274,185,69,116,119,36,83,270,55,215,4604,32067,18967,"Torrance County, New Mexico",57,35,29.51471248
1826,35059,Union County, New Mexico,40.4,4292,223,8,0,8,25,0,25,101,0,101,89,64,25,614,36420,21091,"Union County, New Mexico",59,35,14.305685
1827,35061,Valencia County, New Mexico,38.9,75993,6233,254,52,202,1344,499,845,2215,633,1582,2420,1376,1044,17177,41788,19842,"Valencia County, New Mexico",61,35,22.60339768
1828,36001,Albany County, New York,37.8,307891,28702,6739,463,6276,7967,3580,4387,5761,4416,1345,8235,7232,1003,37749,60904,33888,"Albany County, New York",1,36,12.26050778
1829,36003,Allegany County, New York,38.5,47700,1098,357,24,333,227,84,143,138,93,45,376,272,104,7284,44085,21478,"Allegany County, New York",3,36,15.27044025
1830,36005,Bronx County, New York,33.3,1436785,501608,70191,6686,63505,150854,46119,104735,129576,71461,58115,150987,113422,37565,427715,35302,18896,"Bronx County, New York",5,36,29.76889375
1831,36007,Broome County, New York,39.8,197381,12976,2674,264,2410,3247,1535,1712,2616,1989,627,4439,3614,825,32624,47744,25880,"Broome County, New York",7,36,16.52843992
1832,36009,Cattaraugus County, New York,41.5,78506,1664,214,13,201,414,142,272,378,287,91,658,543,115,13265,43884,22832,"Cattaraugus County, New York",9,36,16.8967977
1833,36011,Cayuga County, New York,42.4,78783,1833,271,41,230,560,254,306,267,189,78,735,521,214,8494,53114,26596,"Cayuga County, New York",11,36,10.78151378
1834,36013,Chautauqua County, New York,42,131748,2752,545,33,512,504,114,390,543,253,290,1160,918,242,24410,43211,23249,"Chautauqua County, New York",13,36,18.52779549
1835,36015,Chemung County, New York,41,87742,2455,328,65,263,514,167,347,638,474,164,975,804,171,13179,49578,26196,"Chemung County, New York",15,36,15.02017278
1836,36017,Chenango County, New York,44.1,49286,884,69,4,65,210,71,139,136,64,72,469,339,130,7468,46979,23805,"Chenango County, New York",17,36,15.15237593
1837,36019,Clinton County, New York,39.4,81505,3519,692,77,615,543,232,311,861,504,357,1423,989,434,11865,50502,25024,"Clinton County, New York",19,36,14.55738912
1838,36021,Columbia County, New York,47,61860,4117,686,59,627,932,254,678,666,398,268,1833,1451,382,7605,59916,33864,"Columbia County, New York",21,36,12.29388943
1839,36023,Cortland County, New York,36.2,48713,1046,68,0,68,302,153,149,155,124,31,521,421,100,6209,50910,24665,"Cortland County, New York",23,36,12.74608421
1840,36025,Delaware County, New York,46.5,46480,1865,180,10,170,321,101,220,323,186,137,1041,764,277,6987,46055,24753,"Delaware County, New York",25,36,15.03227194
1841,36027,Dutchess County, New York,41.6,295905,33600,3402,310,3092,7686,3078,4608,7353,3977,3376,15159,12383,2776,25562,72706,35101,"Dutchess County, New York",27,36,8.638583329
1842,36029,Erie County, New York,40.4,922129,61368,15089,756,14333,17155,6860,10295,9945,7044,2901,19179,15934,3245,132072,52744,29940,"Erie County, New York",29,36,14.32250802
1843,36031,Essex County, New York,46.4,38598,1266,153,7,146,181,31,150,270,67,203,662,462,200,3638,53244,28155,"Essex County, New York",31,36,9.425358827
1844,36033,Franklin County, New York,40.1,51007,2062,58,0,58,418,204,214,740,421,319,846,544,302,8706,49782,23660,"Franklin County, New York",33,36,17.06824553
1845,36035,Fulton County, New York,43,54297,1014,74,2,72,206,78,128,182,75,107,552,443,109,8861,46090,25092,"Fulton County, New York",35,36,16.319502
1846,36037,Genesee County, New York,43.2,59053,1123,107,18,89,185,91,94,163,97,66,668,514,154,7245,52641,26381,"Genesee County, New York",37,36,12.26864004
1847,36039,Greene County, New York,45.4,48069,2867,378,17,361,448,181,267,366,230,136,1675,1332,343,5826,51013,26307,"Greene County, New York",39,36,12.12007739
1848,36041,Hamilton County, New York,53.5,4697,127,5,2,3,18,10,8,7,6,1,97,47,50,526,52708,27371,"Hamilton County, New York",41,36,11.19863743
1849,36043,Herkimer County, New York,43.3,63558,1847,129,17,112,339,170,169,478,390,88,901,761,140,8738,48893,24678,"Herkimer County, New York",43,36,13.74807263
1850,36045,Jefferson County, New York,32,117966,4426,682,71,611,1370,688,682,1140,799,341,1234,922,312,16236,49911,24172,"Jefferson County, New York",45,36,13.76328773
1851,36047,Kings County, New York,34.5,2606852,970553,108157,11507,96650,250526,89044,161482,270011,177409,92602,341859,282312,59547,587518,50640,28134,"Kings County, New York",47,36,22.5374513
1852,36049,Lewis County, New York,41.8,27107,431,99,0,99,112,22,90,118,33,85,102,80,22,3750,49976,25230,"Lewis County, New York",49,36,13.834065
1853,36051,Livingston County, New York,40.4,64622,2154,497,26,471,353,173,180,325,239,86,979,779,200,8720,52724,24596,"Livingston County, New York",51,36,13.49385658
1854,36053,Madison County, New York,41.1,72089,1806,249,0,249,486,213,273,420,330,90,651,475,176,7932,55858,26824,"Madison County, New York",53,36,11.00306565
1855,36055,Monroe County, New York,38.6,749236,63391,11415,537,10878,16339,6331,10008,11762,8525,3237,23875,20025,3850,107724,53568,30194,"Monroe County, New York",55,36,14.37784623
1856,36057,Montgomery County, New York,41.3,49667,1685,207,20,187,317,134,183,290,192,98,871,733,138,10014,44455,23885,"Montgomery County, New York",57,36,20.16228079
1857,36059,Nassau County, New York,41.4,1356801,296079,22849,2603,20246,63884,21048,42836,68652,41493,27159,140694,118792,21902,80282,102044,44548,"Nassau County, New York",59,36,5.917006252
1858,36061,New York County, New York,36.7,1634989,472404,84746,4444,80302,115911,29231,86680,100849,58579,42270,170898,135167,35731,279847,75513,66522,"New York County, New York",61,36,17.11613962
1859,36063,Niagara County, New York,42.9,213374,8438,852,130,722,1939,811,1128,1393,1035,358,4254,3252,1002,28523,50094,27487,"Niagara County, New York",63,36,13.36760805
1860,36065,Oneida County, New York,41.2,232858,17803,3169,156,3013,5919,2380,3539,4417,3275,1142,4298,3210,1088,36789,49838,26577,"Oneida County, New York",65,36,15.7988989
1861,36067,Onondaga County, New York,38.8,468050,34507,8145,461,7684,9575,3943,5632,6782,4717,2065,10005,8297,1708,68285,55717,30225,"Onondaga County, New York",67,36,14.58925328
1862,36069,Ontario County, New York,43.3,109450,4110,597,30,567,1010,335,675,952,670,282,1551,1180,371,10898,58070,31524,"Ontario County, New York",69,36,9.957058017
1863,36071,Orange County, New York,36.9,376242,40713,2937,566,2371,10297,3868,6429,10883,5991,4892,16596,13191,3405,46342,71910,31272,"Orange County, New York",71,36,12.31707252
1864,36073,Orleans County, New York,42.6,41938,1464,153,0,153,477,69,408,231,70,161,603,468,135,6089,48731,23332,"Orleans County, New York",73,36,14.51905193
1865,36075,Oswego County, New York,39.5,120513,2280,249,0,249,524,292,232,451,286,165,1056,770,286,21100,49571,24284,"Oswego County, New York",75,36,17.50848456
1866,36077,Otsego County, New York,41.6,60979,2185,259,19,240,401,241,160,424,330,94,1101,790,311,9106,49689,24989,"Otsego County, New York",77,36,14.93300972
1867,36079,Putnam County, New York,43.4,99408,12555,890,162,728,3095,1129,1966,3053,1870,1183,5517,4697,820,5061,97606,41993,"Putnam County, New York",79,36,5.091139546
1868,36081,Queens County, New York,37.9,2310011,1098020,117040,12750,104290,307398,107898,199500,292672,179085,113587,380910,314193,66717,334149,59758,27631,"Queens County, New York",81,36,14.46525579
1869,36083,Rensselaer County, New York,39.8,159959,7584,1688,43,1645,1776,819,957,1731,1216,515,2389,1965,424,19064,61754,31529,"Rensselaer County, New York",83,36,11.918054
1870,36085,Richmond County, New York,39.6,473324,103527,7574,1109,6465,22972,9617,13355,32939,23645,9294,40042,34219,5823,60530,74021,32678,"Richmond County, New York",85,36,12.78828033
1871,36087,Rockland County, New York,36.3,322642,68682,6381,505,5876,17815,5086,12729,15828,9278,6550,28658,24034,4624,46128,86134,35557,"Rockland County, New York",87,36,14.29696072
1872,36089,St. Lawrence County, New York,38,111529,4731,853,37,816,1171,317,854,929,603,326,1778,1311,467,19107,46313,23313,"St. Lawrence County, New York",89,36,17.13186705
1873,36091,Saratoga County, New York,42,224929,11489,2098,144,1954,3237,1032,2205,2280,1644,636,3874,3159,715,14193,74080,37583,"Saratoga County, New York",91,36,6.309991153
1874,36093,Schenectady County, New York,39.9,154845,15822,1967,114,1853,5305,3276,2029,3524,2640,884,5026,4291,735,18055,59959,29212,"Schenectady County, New York",93,36,11.66004714
1875,36095,Schoharie County, New York,43.6,31667,928,53,0,53,257,134,123,126,98,28,492,406,86,4273,50607,25638,"Schoharie County, New York",95,36,13.49354217
1876,36097,Schuyler County, New York,46,18336,360,77,14,63,38,13,25,65,59,6,180,96,84,2617,47229,25004,"Schuyler County, New York",97,36,14.27246946
1877,36099,Seneca County, New York,42.2,35036,870,105,14,91,115,62,53,258,182,76,392,336,56,3952,50073,25680,"Seneca County, New York",99,36,11.27982646
1878,36101,Steuben County, New York,42.3,98151,2299,402,17,385,785,235,550,345,191,154,767,717,50,14558,48823,26830,"Steuben County, New York",101,36,14.83224827
1879,36103,Suffolk County, New York,40.9,1498130,230820,20048,1983,18065,60856,16411,44445,62793,31975,30818,87123,67816,19307,106499,90128,38779,"Suffolk County, New York",103,36,7.108795632
1880,36105,Sullivan County, New York,42.5,75818,7356,338,20,318,1933,373,1560,1485,800,685,3600,2637,963,12479,52027,27068,"Sullivan County, New York",105,36,16.45915218
1881,36107,Tioga County, New York,43.9,49649,1107,115,36,79,205,112,93,180,159,21,607,580,27,5405,58115,29654,"Tioga County, New York",107,36,10.88642269
1882,36109,Tompkins County, New York,30.3,104268,13333,5810,151,5659,3025,688,2337,2324,1693,631,2174,1797,377,18133,54133,28888,"Tompkins County, New York",109,36,17.39076227
1883,36111,Ulster County, New York,43.4,180505,13730,1779,145,1634,3198,973,2225,2626,1459,1167,6127,4855,1272,22480,60393,31760,"Ulster County, New York",111,36,12.45394864
1884,36113,Warren County, New York,45.6,64911,2206,292,0,292,328,106,222,410,196,214,1176,904,272,7079,57174,31652,"Warren County, New York",113,36,10.90570165
1885,36115,Washington County, New York,43.2,62465,1383,137,0,137,207,116,91,319,213,106,720,545,175,7627,51449,25200,"Washington County, New York",115,36,12.21003762
1886,36117,Wayne County, New York,43.4,91874,2456,276,125,151,500,228,272,503,422,81,1177,1001,176,10761,51627,26209,"Wayne County, New York",117,36,11.71278055
1887,36119,Westchester County, New York,40.5,969229,247410,25621,2002,23619,65225,15893,49332,58442,29861,28581,98122,78008,20114,92600,86226,49938,"Westchester County, New York",119,36,9.553985694
1888,36121,Wyoming County, New York,41.4,41239,744,75,2,73,282,95,187,128,25,103,259,159,100,4312,53612,24610,"Wyoming County, New York",121,36,10.45612163
1889,36123,Yates County, New York,41.5,25106,613,299,10,289,67,11,56,47,27,20,200,135,65,3319,50105,26001,"Yates County, New York",123,36,13.21994742
1890,37001,Alamance County, North Carolina,39.6,156372,12726,1060,41,1019,3926,808,3118,5061,1188,3873,2679,1853,826,28123,43209,23989,"Alamance County, North Carolina",1,37,17.98467756
1891,37003,Alexander County, North Carolina,42.4,37211,1001,158,0,158,287,34,253,294,46,248,262,149,113,6240,40404,20567,"Alexander County, North Carolina",3,37,16.7692349
1892,37005,Alleghany County, North Carolina,48.5,10868,594,65,27,38,226,8,218,243,18,225,60,35,25,2089,38352,21059,"Alleghany County, North Carolina",5,37,19.22156791
1893,37007,Anson County, North Carolina,39.9,25883,869,105,8,97,336,20,316,314,42,272,114,86,28,5484,34656,17548,"Anson County, North Carolina",7,37,21.18765213
1894,37009,Ashe County, North Carolina,46.9,26992,1091,30,0,30,361,38,323,405,48,357,295,149,146,5290,37360,22343,"Ashe County, North Carolina",9,37,19.59839953
1895,37011,Avery County, North Carolina,44,17633,725,80,0,80,277,16,261,261,31,230,107,67,40,2509,35891,21548,"Avery County, North Carolina",11,37,14.22900244
1896,37013,Beaufort County, North Carolina,45.2,47513,1790,122,45,77,559,107,452,639,54,585,470,381,89,8215,40906,23716,"Beaufort County, North Carolina",13,37,17.29000484
1897,37015,Bertie County, North Carolina,45,20324,332,54,0,54,219,0,219,28,1,27,31,12,19,3992,31129,17244,"Bertie County, North Carolina",15,37,19.64180279
1898,37017,Bladen County, North Carolina,42.9,34454,1519,134,0,134,670,48,622,548,8,540,167,91,76,9549,30408,19510,"Bladen County, North Carolina",17,37,27.71521449
1899,37019,Brunswick County, North Carolina,50.9,119167,5121,231,25,206,1633,216,1417,1237,527,710,2020,1621,399,17992,49356,28694,"Brunswick County, North Carolina",19,37,15.09813959
1900,37021,Buncombe County, North Carolina,41.7,250112,13585,1795,181,1614,5447,1467,3980,3132,1426,1706,3211,2544,667,35996,46902,28087,"Buncombe County, North Carolina",21,37,14.39195241
1901,37023,Burke County, North Carolina,43.3,89082,4252,418,59,359,1378,285,1093,1041,315,726,1415,967,448,17135,39759,20775,"Burke County, North Carolina",23,37,19.23508677
1902,37025,Cabarrus County, North Carolina,37.7,192296,14858,1777,188,1589,4724,859,3865,5164,1801,3363,3193,2341,852,22324,58970,27728,"Cabarrus County, North Carolina",25,37,11.60918584
1903,37027,Caldwell County, North Carolina,43.5,81623,2803,434,88,346,1039,268,771,838,241,597,492,372,120,14137,37118,20587,"Caldwell County, North Carolina",27,37,17.31987307
1904,37029,Camden County, North Carolina,40.9,10228,317,64,0,64,71,5,66,62,25,37,120,120,0,1060,60714,26420,"Camden County, North Carolina",29,37,10.36370747
1905,37031,Carteret County, North Carolina,46.9,68537,2529,307,29,278,749,117,632,586,103,483,887,705,182,8869,50599,29349,"Carteret County, North Carolina",31,37,12.94045552
1906,37033,Caswell County, North Carolina,45.3,23094,598,116,11,105,180,30,150,193,83,110,109,74,35,4888,38310,20235,"Caswell County, North Carolina",33,37,21.16567074
1907,37035,Catawba County, North Carolina,41.1,155461,10686,1539,235,1304,2663,780,1883,3833,1192,2641,2651,2056,595,24269,45450,24220,"Catawba County, North Carolina",35,37,15.61098925
1908,37037,Chatham County, North Carolina,46.9,68778,5832,257,0,257,2195,186,2009,2072,782,1290,1308,951,357,9185,58555,35109,"Chatham County, North Carolina",37,37,13.35456105
1909,37039,Cherokee County, North Carolina,50.4,27226,667,3,3,0,188,10,178,107,69,38,369,320,49,5247,35284,19285,"Cherokee County, North Carolina",39,37,19.27201939
1910,37041,Chowan County, North Carolina,45.3,14556,417,0,0,0,136,0,136,84,0,84,197,184,13,3491,41156,22173,"Chowan County, North Carolina",41,37,23.98323715
1911,37043,Clay County, North Carolina,50.8,10730,318,21,0,21,151,0,151,10,3,7,136,125,11,1731,36296,23076,"Clay County, North Carolina",43,37,16.13233924
1912,37045,Cleveland County, North Carolina,41.5,97113,2641,442,38,404,705,84,621,610,140,470,884,660,224,19866,39134,20677,"Cleveland County, North Carolina",45,37,20.45658151
1913,37047,Columbus County, North Carolina,41.6,57015,1561,173,17,156,512,198,314,611,102,509,265,146,119,12443,35847,21133,"Columbus County, North Carolina",47,37,21.82408138
1914,37049,Craven County, North Carolina,36.1,104190,5149,987,6,981,1747,597,1150,1162,490,672,1253,997,256,15205,47957,25230,"Craven County, North Carolina",49,37,14.59353105
1915,37051,Cumberland County, North Carolina,31.5,325841,19189,2880,367,2513,5372,2300,3072,4132,2748,1384,6805,5273,1532,55235,44810,23148,"Cumberland County, North Carolina",51,37,16.9515193
1916,37053,Currituck County, North Carolina,43.2,24864,717,48,0,48,313,57,256,122,71,51,234,204,30,2468,61086,28202,"Currituck County, North Carolina",53,37,9.925997426
1917,37055,Dare County, North Carolina,45.3,35187,1805,174,14,160,599,131,468,544,122,422,488,286,202,2885,54787,29746,"Dare County, North Carolina",55,37,8.199050786
1918,37057,Davidson County, North Carolina,41.9,164058,7763,300,48,252,3165,545,2620,2483,977,1506,1815,1107,708,26221,44469,23146,"Davidson County, North Carolina",57,37,15.98276219
1919,37059,Davie County, North Carolina,44.3,41568,1817,167,0,167,590,76,514,571,281,290,489,389,100,5735,51662,28178,"Davie County, North Carolina",59,37,13.79667052
1920,37061,Duplin County, North Carolina,39.2,59121,6915,650,39,611,2986,70,2916,2403,226,2177,876,378,498,16106,35364,17960,"Duplin County, North Carolina",61,37,27.24243501
1921,37063,Durham County, North Carolina,34.6,294618,40242,8217,225,7992,15669,3397,12272,9684,3204,6480,6672,4961,1711,48907,54093,31473,"Durham County, North Carolina",63,37,16.60013984
1922,37065,Edgecombe County, North Carolina,40.3,54669,1278,88,0,88,525,44,481,515,35,480,150,75,75,13750,32298,18009,"Edgecombe County, North Carolina",65,37,25.15136549
1923,37067,Forsyth County, North Carolina,38,364691,30913,2712,204,2508,11987,2915,9072,9818,2859,6959,6396,4381,2015,69253,46283,27593,"Forsyth County, North Carolina",67,37,18.9895007
1924,37069,Franklin County, North Carolina,40.4,62989,3248,408,63,345,1179,80,1099,913,271,642,748,574,174,9967,44272,22394,"Franklin County, North Carolina",69,37,15.82339774
1925,37071,Gaston County, North Carolina,40,211753,10932,939,162,777,4565,750,3815,2494,1017,1477,2934,2274,660,35812,44288,23710,"Gaston County, North Carolina",71,37,16.91215709
1926,37073,Gates County, North Carolina,44.6,11615,186,31,0,31,18,18,0,101,18,83,36,21,15,1391,51582,23602,"Gates County, North Carolina",73,37,11.97589324
1927,37075,Graham County, North Carolina,44.8,8651,134,57,0,57,12,0,12,20,0,20,45,45,0,1650,34778,18783,"Graham County, North Carolina",75,37,19.07293954
1928,37077,Granville County, North Carolina,41.9,58341,2418,104,4,100,865,162,703,811,209,602,638,421,217,9109,50317,23563,"Granville County, North Carolina",77,37,15.61337653
1929,37079,Greene County, North Carolina,39.8,21241,1573,95,10,85,664,48,616,561,24,537,253,117,136,4646,37190,18682,"Greene County, North Carolina",79,37,21.87279318
1930,37081,Guilford County, North Carolina,37.1,511815,52004,9034,500,8534,20053,5037,15016,14074,6359,7715,8843,6406,2437,87165,46896,27531,"Guilford County, North Carolina",81,37,17.03056769
1931,37083,Halifax County, North Carolina,42.4,52849,987,94,0,94,405,82,323,209,160,49,279,219,60,13782,32549,20134,"Halifax County, North Carolina",83,37,26.07807149
1932,37085,Harnett County, North Carolina,33.7,126620,7255,601,54,547,2609,650,1959,2201,651,1550,1844,1279,565,22461,47930,21214,"Harnett County, North Carolina",85,37,17.73890381
1933,37087,Haywood County, North Carolina,47.2,59577,1442,26,0,26,576,171,405,321,212,109,519,336,183,9851,43097,26483,"Haywood County, North Carolina",87,37,16.53490441
1934,37089,Henderson County, North Carolina,46.8,110905,8282,667,0,667,2856,384,2472,2374,886,1488,2385,1622,763,14559,48138,26534,"Henderson County, North Carolina",89,37,13.12745142
1935,37091,Hertford County, North Carolina,41.9,24285,832,170,0,170,252,15,237,136,22,114,274,122,152,5217,34523,17650,"Hertford County, North Carolina",91,37,21.48239654
1936,37093,Hoke County, North Carolina,31.7,51853,3170,242,9,233,1539,362,1177,793,312,481,596,477,119,11545,42704,18715,"Hoke County, North Carolina",93,37,22.26486414
1937,37095,Hyde County, North Carolina,41.8,5629,199,0,0,0,40,0,40,147,0,147,12,12,0,1108,37741,18770,"Hyde County, North Carolina",95,37,19.68378042
1938,37097,Iredell County, North Carolina,40.4,167493,10480,1353,34,1319,3689,648,3041,2967,895,2072,2471,1880,591,22114,53937,28268,"Iredell County, North Carolina",97,37,13.20293982
1939,37099,Jackson County, North Carolina,37.1,41227,1478,433,37,396,629,88,541,127,61,66,289,258,31,8646,40278,21903,"Jackson County, North Carolina",99,37,20.97169331
1940,37101,Johnston County, North Carolina,37.7,182155,13561,1173,123,1050,5523,683,4840,4347,1157,3190,2518,1373,1145,26272,51980,23171,"Johnston County, North Carolina",101,37,14.42288161
1941,37103,Jones County, North Carolina,47,10074,321,7,0,7,179,15,164,52,8,44,83,43,40,2285,34080,20348,"Jones County, North Carolina",103,37,22.68215207
1942,37105,Lee County, North Carolina,37.6,59540,6670,526,0,526,2331,321,2010,2280,517,1763,1533,941,592,10673,46402,22389,"Lee County, North Carolina",105,37,17.92576419
1943,37107,Lenoir County, North Carolina,42.1,58343,2652,402,10,392,905,12,893,760,109,651,585,366,219,12614,36956,20773,"Lenoir County, North Carolina",107,37,21.62041719
1944,37109,Lincoln County, North Carolina,42.4,79783,3900,212,30,182,1305,247,1058,1047,206,841,1336,790,546,11907,49283,26352,"Lincoln County, North Carolina",109,37,14.92423198
1945,37111,McDowell County, North Carolina,43.1,45013,1715,264,7,257,463,87,376,729,162,567,259,200,59,8814,37590,19233,"McDowell County, North Carolina",111,37,19.58100993
1946,37113,Macon County, North Carolina,49,33991,1675,301,0,301,417,29,388,462,88,374,495,382,113,6183,39593,25195,"Macon County, North Carolina",113,37,18.19010915
1947,37115,Madison County, North Carolina,43.9,21130,488,67,6,61,112,32,80,91,19,72,218,140,78,3337,40408,22278,"Madison County, North Carolina",115,37,15.79271178
1948,37117,Martin County, North Carolina,46.2,23510,318,0,0,0,51,0,51,101,21,80,166,90,76,4721,34957,21149,"Martin County, North Carolina",117,37,20.08081667
1949,37119,Mecklenburg County, North Carolina,34.7,1011774,148392,26748,1412,25336,56128,12947,43181,36138,16867,19271,29378,22274,7104,141024,59268,34091,"Mecklenburg County, North Carolina",119,37,13.93829057
1950,37121,Mitchell County, North Carolina,46.9,15263,409,107,0,107,172,50,122,48,6,42,82,35,47,2688,39658,22130,"Mitchell County, North Carolina",121,37,17.61121667
1951,37123,Montgomery County, North Carolina,41.4,27475,2423,61,33,28,1109,127,982,898,306,592,355,130,225,5821,34819,20007,"Montgomery County, North Carolina",123,37,21.18653321
1952,37125,Moore County, North Carolina,45,93070,4381,637,42,595,1068,348,720,1371,308,1063,1305,1106,199,13478,51873,29679,"Moore County, North Carolina",125,37,14.48157301
1953,37127,Nash County, North Carolina,41.2,94385,4047,399,58,341,1399,237,1162,1439,365,1074,810,559,251,16057,43804,24106,"Nash County, North Carolina",127,37,17.01223711
1954,37129,New Hanover County, North Carolina,38.4,216430,11501,1195,76,1119,4943,806,4137,2246,1202,1044,3117,2391,726,37167,51232,30375,"New Hanover County, North Carolina",129,37,17.17275794
1955,37131,Northampton County, North Carolina,48.2,20628,282,56,0,56,110,0,110,46,9,37,70,49,21,5616,31543,18836,"Northampton County, North Carolina",131,37,27.22513089
1956,37133,Onslow County, North Carolina,26.4,185755,7435,894,225,669,1967,769,1198,1949,1009,940,2625,2091,534,23890,46786,22590,"Onslow County, North Carolina",133,37,12.86102662
1957,37135,Orange County, North Carolina,33.6,139807,17796,3802,155,3647,6076,1706,4370,3961,1787,2174,3957,3113,844,18713,61130,37103,"Orange County, North Carolina",135,37,13.38488059
1958,37137,Pamlico County, North Carolina,50.4,12892,355,21,7,14,112,10,102,81,3,78,141,112,29,1773,43808,24332,"Pamlico County, North Carolina",137,37,13.75271486
1959,37139,Pasquotank County, North Carolina,37.8,39909,1613,361,11,350,521,171,350,214,84,130,517,388,129,6521,45750,22549,"Pasquotank County, North Carolina",139,37,16.33967276
1960,37141,Pender County, North Carolina,42.7,56358,2203,206,29,177,486,61,425,764,126,638,747,454,293,10304,46580,24031,"Pender County, North Carolina",141,37,18.28311863
1961,37143,Perquimans County, North Carolina,47.9,13470,321,13,0,13,57,0,57,59,0,59,192,157,35,2208,45208,25407,"Perquimans County, North Carolina",143,37,16.39198218
1962,37145,Person County, North Carolina,42.8,39196,969,45,0,45,460,76,384,330,104,226,134,79,55,7127,43297,22049,"Person County, North Carolina",145,37,18.18297785
1963,37147,Pitt County, North Carolina,31.7,175150,8276,976,63,913,3346,677,2669,1974,727,1247,1980,984,996,41412,42308,24066,"Pitt County, North Carolina",147,37,23.64373394
1964,37149,Polk County, North Carolina,51.3,20324,683,34,0,34,140,53,87,199,87,112,310,212,98,2902,47396,28175,"Polk County, North Carolina",149,37,14.2786853
1965,37151,Randolph County, North Carolina,41.1,142588,9179,782,0,782,2668,219,2449,3740,649,3091,1989,1219,770,23757,43010,21731,"Randolph County, North Carolina",151,37,16.66128987
1966,37153,Richmond County, North Carolina,40,45710,1612,137,15,122,654,31,623,428,108,320,393,212,181,11443,32526,19411,"Richmond County, North Carolina",153,37,25.03390943
1967,37155,Robeson County, North Carolina,35.6,134576,6456,511,54,457,2623,261,2362,2247,402,1845,1075,596,479,40313,31298,16221,"Robeson County, North Carolina",155,37,29.95556414
1968,37157,Rockingham County, North Carolina,44.1,91898,3083,231,28,203,1081,176,905,1012,315,697,759,336,423,17517,40003,21298,"Rockingham County, North Carolina",157,37,19.06135063
1969,37159,Rowan County, North Carolina,40.3,138694,6335,439,35,404,2510,529,1981,2076,662,1414,1310,905,405,24142,44494,22463,"Rowan County, North Carolina",159,37,17.40666503
1970,37161,Rutherford County, North Carolina,44.1,66701,2006,34,0,34,630,331,299,702,126,576,640,541,99,12668,36144,19688,"Rutherford County, North Carolina",161,37,18.99221901
1971,37163,Sampson County, North Carolina,39.5,63713,6200,789,10,779,2136,133,2003,2265,377,1888,1010,507,503,15207,36742,19871,"Sampson County, North Carolina",163,37,23.86797043
1972,37165,Scotland County, North Carolina,39.4,35711,781,135,7,128,279,24,255,186,83,103,181,125,56,10480,30013,16192,"Scotland County, North Carolina",165,37,29.3466999
1973,37167,Stanly County, North Carolina,42.1,60610,1841,220,32,188,453,52,401,647,133,514,521,303,218,10047,44140,22103,"Stanly County, North Carolina",167,37,16.57647253
1974,37169,Stokes County, North Carolina,45.1,46453,769,13,0,13,142,4,138,325,38,287,289,151,138,7052,42489,22013,"Stokes County, North Carolina",169,37,15.18093557
1975,37171,Surry County, North Carolina,43,72767,3843,398,26,372,1554,327,1227,1296,198,1098,595,438,157,12801,37345,21411,"Surry County, North Carolina",171,37,17.5917655
1976,37173,Swain County, North Carolina,40.7,14234,241,2,0,2,123,29,94,17,17,0,99,56,43,3277,33598,20256,"Swain County, North Carolina",173,37,23.02234087
1977,37175,Transylvania County, North Carolina,50.4,33062,1336,120,0,120,477,0,477,258,95,163,481,378,103,4598,43918,25394,"Transylvania County, North Carolina",175,37,13.90720465
1978,37177,Tyrrell County, North Carolina,45.3,4128,242,0,0,0,72,0,72,135,38,97,35,15,20,905,32165,17042,"Tyrrell County, North Carolina",177,37,21.92344961
1979,37179,Union County, North Carolina,37.7,217614,19754,1318,202,1116,7378,1869,5509,6508,2617,3891,4550,3528,1022,20772,67194,31185,"Union County, North Carolina",179,37,9.545341752
1980,37181,Vance County, North Carolina,40.5,44508,1764,220,0,220,559,15,544,556,46,510,429,340,89,11177,32733,18703,"Vance County, North Carolina",181,37,25.11233935
1981,37183,Wake County, North Carolina,35.6,998576,129927,23611,1305,22306,45883,12588,33295,34351,18574,15777,26082,20876,5206,105133,70620,35752,"Wake County, North Carolina",183,37,10.52829229
1982,37185,Warren County, North Carolina,46.5,20324,663,9,0,9,207,60,147,320,106,214,127,98,29,4662,33913,19563,"Warren County, North Carolina",185,37,22.93839795
1983,37187,Washington County, North Carolina,44.9,12503,298,96,0,96,151,0,151,7,1,6,44,41,3,2916,33286,20423,"Washington County, North Carolina",187,37,23.32240262
1984,37189,Watauga County, North Carolina,30.1,52745,1538,230,0,230,451,89,362,495,250,245,362,292,70,14797,39443,22892,"Watauga County, North Carolina",189,37,28.05384397
1985,37191,Wayne County, North Carolina,37,124447,9299,1643,83,1560,3712,572,3140,2557,726,1831,1387,802,585,26475,40457,21674,"Wayne County, North Carolina",191,37,21.27411669
1986,37193,Wilkes County, North Carolina,44.1,68888,2848,283,8,275,975,94,881,957,54,903,633,359,274,14278,34846,20145,"Wilkes County, North Carolina",193,37,20.72639647
1987,37195,Wilson County, North Carolina,40.3,81617,5518,629,119,510,2146,350,1796,1534,419,1115,1209,629,580,18043,40260,22519,"Wilson County, North Carolina",195,37,22.106914
1988,37197,Yadkin County, North Carolina,43,37819,1964,188,9,179,746,163,583,714,156,558,316,102,214,7112,38623,21820,"Yadkin County, North Carolina",197,37,18.80536238
1989,37199,Yancey County, North Carolina,46.3,17599,533,15,0,15,233,22,211,210,30,180,75,55,20,3713,36993,21508,"Yancey County, North Carolina",199,37,21.09778965
1990,38001,Adams County, North Dakota,45.1,2348,45,35,0,35,7,0,7,3,0,3,0,0,0,241,53295,32594,"Adams County, North Dakota",1,38,10.26405451
1991,38003,Barnes County, North Dakota,43.5,11033,107,0,0,0,50,12,38,23,0,23,34,25,9,1025,55778,34244,"Barnes County, North Dakota",3,38,9.290310886
1992,38005,Benson County, North Dakota,30.8,6802,32,0,0,0,19,5,14,1,1,0,12,7,5,2270,41530,20561,"Benson County, North Dakota",5,38,33.37253749
1993,38007,Billings County, North Dakota,45.8,936,16,3,0,3,0,0,0,13,13,0,0,0,0,103,67969,40549,"Billings County, North Dakota",7,38,11.0042735
1994,38009,Bottineau County, North Dakota,45.2,6650,155,18,0,18,64,13,51,18,16,2,55,53,2,569,55958,32661,"Bottineau County, North Dakota",9,38,8.556390977
1995,38011,Bowman County, North Dakota,42.6,3238,25,0,0,0,4,4,0,0,0,0,21,3,18,242,62955,34388,"Bowman County, North Dakota",11,38,7.473749228
1996,38013,Burke County, North Dakota,38.6,2239,72,1,0,1,28,3,25,14,1,13,29,25,4,265,65521,35857,"Burke County, North Dakota",13,38,11.83564091
1997,38015,Burleigh County, North Dakota,36.7,90560,1898,579,63,516,504,222,282,401,237,164,414,357,57,6745,66057,36093,"Burleigh County, North Dakota",15,38,7.448100707
1998,38017,Cass County, North Dakota,32,166852,10744,3508,118,3390,4029,1669,2360,2543,1824,719,664,524,140,19089,54926,32485,"Cass County, North Dakota",17,38,11.44067797
1999,38019,Cavalier County, North Dakota,50.3,3867,37,10,0,10,14,10,4,0,0,0,13,7,6,198,65645,39779,"Cavalier County, North Dakota",19,38,5.120248254
2000,38021,Dickey County, North Dakota,43.2,5160,91,29,11,18,37,7,30,11,0,11,14,14,0,417,55882,28843,"Dickey County, North Dakota",21,38,8.081395349
2001,38023,Divide County, North Dakota,50.3,2369,100,30,8,22,17,17,0,8,0,8,45,41,4,215,62470,41063,"Divide County, North Dakota",23,38,9.075559308
2002,38025,Dunn County, North Dakota,39.9,4284,87,22,3,19,16,8,8,3,3,0,46,27,19,490,66964,40102,"Dunn County, North Dakota",25,38,11.4379085
2003,38027,Eddy County, North Dakota,46.6,2370,32,3,0,3,3,0,3,11,0,11,15,12,3,306,55489,33785,"Eddy County, North Dakota",27,38,12.91139241
2004,38029,Emmons County, North Dakota,51.1,3426,45,16,0,16,17,17,0,0,0,0,12,4,8,403,45472,29467,"Emmons County, North Dakota",29,38,11.76298891
2005,38031,Foster County, North Dakota,46.7,3345,43,4,0,4,39,0,39,0,0,0,0,0,0,306,55625,30310,"Foster County, North Dakota",31,38,9.147982063
2006,38033,Golden Valley County, North Dakota,41,1895,2,0,0,0,0,0,0,0,0,0,2,2,0,175,37014,26536,"Golden Valley County, North Dakota",33,38,9.234828496
2007,38035,Grand Forks County, North Dakota,29.5,69793,2850,1104,31,1073,859,354,505,376,242,134,511,396,115,11507,50652,29376,"Grand Forks County, North Dakota",35,38,16.48732681
2008,38037,Grant County, North Dakota,53.6,2369,28,10,0,10,3,0,3,2,0,2,13,8,5,315,45978,32200,"Grant County, North Dakota",37,38,13.29674968
2009,38039,Griggs County, North Dakota,51.9,2311,25,0,0,0,0,0,0,14,8,6,11,11,0,161,50250,31866,"Griggs County, North Dakota",39,38,6.96668109
2010,38041,Hettinger County, North Dakota,48.6,2639,33,5,0,5,12,0,12,3,0,3,13,11,2,207,55230,31074,"Hettinger County, North Dakota",41,38,7.843880258
2011,38043,Kidder County, North Dakota,45.9,2419,43,23,0,23,14,5,9,6,6,0,0,0,0,170,58527,36779,"Kidder County, North Dakota",43,38,7.027697396
2012,38045,LaMoure County, North Dakota,48.2,4111,30,0,0,0,2,1,1,9,9,0,19,19,0,384,55900,36493,"LaMoure County, North Dakota",45,38,9.340792994
2013,38047,Logan County, North Dakota,52.6,1939,24,14,3,11,9,0,9,0,0,0,1,1,0,130,55068,33272,"Logan County, North Dakota",47,38,6.704486849
2014,38049,McHenry County, North Dakota,42.4,5912,82,1,0,1,38,2,36,25,23,2,18,8,10,583,60741,36072,"McHenry County, North Dakota",49,38,9.861299053
2015,38051,McIntosh County, North Dakota,52.6,2737,76,0,0,0,23,3,20,0,0,0,53,13,40,253,43650,30620,"McIntosh County, North Dakota",51,38,9.243697479
2016,38053,McKenzie County, North Dakota,31.3,10718,94,20,13,7,8,7,1,31,28,3,35,35,0,1361,78179,37938,"McKenzie County, North Dakota",53,38,12.6982646
2017,38055,McLean County, North Dakota,46.6,9576,103,4,0,4,46,43,3,7,3,4,46,31,15,923,59976,34218,"McLean County, North Dakota",55,38,9.638680033
2018,38057,Mercer County, North Dakota,44.5,8671,82,8,0,8,22,18,4,9,3,6,43,39,4,634,73801,34194,"Mercer County, North Dakota",57,38,7.311728751
2019,38059,Morton County, North Dakota,37.5,29633,239,33,0,33,60,29,31,33,24,9,113,91,22,2521,63549,34715,"Morton County, North Dakota",59,38,8.507407282
2020,38061,Mountrail County, North Dakota,35.2,9675,174,34,7,27,17,17,0,50,8,42,73,60,13,1122,68082,39285,"Mountrail County, North Dakota",61,38,11.59689922
2021,38063,Nelson County, North Dakota,52.6,3032,26,5,0,5,5,0,5,0,0,0,16,10,6,253,51280,33895,"Nelson County, North Dakota",63,38,8.344327177
2022,38065,Oliver County, North Dakota,49.2,1768,5,0,0,0,3,0,3,0,0,0,2,2,0,72,66196,35524,"Oliver County, North Dakota",65,38,4.07239819
2023,38067,Pembina County, North Dakota,48.1,7136,294,25,0,25,65,32,33,31,22,9,173,130,43,415,56813,32779,"Pembina County, North Dakota",67,38,5.81558296
2024,38069,Pierce County, North Dakota,46.9,4373,11,0,0,0,1,0,1,4,0,4,6,6,0,766,43086,27926,"Pierce County, North Dakota",69,38,17.51657901
2025,38071,Ramsey County, North Dakota,42.7,11578,92,4,0,4,65,0,65,14,4,10,9,7,2,1217,50776,30372,"Ramsey County, North Dakota",71,38,10.51131456
2026,38073,Ransom County, North Dakota,44.8,5457,82,7,0,7,10,5,5,57,9,48,8,6,2,487,57088,30822,"Ransom County, North Dakota",73,38,8.924317391
2027,38075,Renville County, North Dakota,39.2,2573,78,2,0,2,4,0,4,2,2,0,70,65,5,169,65927,31646,"Renville County, North Dakota",75,38,6.568208317
2028,38077,Richland County, North Dakota,38.2,16329,232,40,0,40,66,40,26,82,64,18,44,24,20,1501,58125,28534,"Richland County, North Dakota",77,38,9.192234675
2029,38079,Rolette County, North Dakota,30.3,14607,94,0,0,0,13,9,4,13,13,0,68,52,16,4523,37313,17744,"Rolette County, North Dakota",79,38,30.96460601
2030,38081,Sargent County, North Dakota,45.3,3889,109,59,0,59,29,12,17,11,2,9,10,10,0,221,57472,33072,"Sargent County, North Dakota",81,38,5.68269478
2031,38083,Sheridan County, North Dakota,51.3,1395,6,0,0,0,0,0,0,1,0,1,5,5,0,235,48375,31244,"Sheridan County, North Dakota",83,38,16.84587814
2032,38085,Sioux County, North Dakota,26.9,4431,25,14,0,14,0,0,0,1,1,0,10,10,0,1646,39539,15338,"Sioux County, North Dakota",85,38,37.1473708
2033,38087,Slope County, North Dakota,52.1,665,0,0,0,0,0,0,0,0,0,0,0,0,0,67,58750,36168,"Slope County, North Dakota",87,38,10.07518797
2034,38089,Stark County, North Dakota,34.5,29837,1182,446,0,446,470,305,165,139,54,85,127,110,17,1961,76817,37681,"Stark County, North Dakota",89,38,6.572376579
2035,38091,Steele County, North Dakota,49.8,1969,31,0,0,0,0,0,0,5,0,5,26,15,11,119,58603,36802,"Steele County, North Dakota",91,38,6.043676993
2036,38093,Stutsman County, North Dakota,40.2,21108,383,145,0,145,148,18,130,47,36,11,43,24,19,2108,53685,30623,"Stutsman County, North Dakota",93,38,9.986734887
2037,38095,Towner County, North Dakota,47.8,2292,47,19,0,19,0,0,0,17,3,14,11,11,0,317,53929,33785,"Towner County, North Dakota",95,38,13.83071553
2038,38097,Traill County, North Dakota,41,8075,133,15,0,15,32,10,22,16,1,15,70,37,33,637,55764,31188,"Traill County, North Dakota",97,38,7.888544892
2039,38099,Walsh County, North Dakota,45.2,10995,431,139,16,123,64,16,48,22,13,9,206,135,71,1134,51181,30266,"Walsh County, North Dakota",99,38,10.31377899
2040,38101,Ward County, North Dakota,31.1,68954,2734,1179,23,1156,814,319,495,202,149,53,539,446,93,4889,63037,32395,"Ward County, North Dakota",101,38,7.090234069
2041,38103,Wells County, North Dakota,51.8,4179,40,5,0,5,20,0,20,0,0,0,15,15,0,214,50685,30260,"Wells County, North Dakota",103,38,5.120842307
2042,38105,Williams County, North Dakota,32,31643,915,121,0,121,394,109,285,240,158,82,160,112,48,3033,90080,45442,"Williams County, North Dakota",105,38,9.585058307
2043,39001,Adams County, Ohio,42.1,28111,180,58,0,58,5,0,5,30,21,9,87,71,16,6770,34709,18901,"Adams County, Ohio",1,39,24.08309914
2044,39003,Allen County, Ohio,38.2,104664,1280,148,0,148,427,119,308,175,89,86,530,475,55,16228,45575,23600,"Allen County, Ohio",3,39,15.50485363
2045,39005,Ashland County, Ohio,40,53343,1133,366,11,355,291,115,176,133,119,14,343,296,47,7859,48509,22604,"Ashland County, Ohio",5,39,14.73295465
2046,39007,Ashtabula County, Ohio,42.2,99175,1396,112,6,106,285,52,233,206,50,156,793,651,142,18735,41158,20978,"Ashtabula County, Ohio",7,39,18.89084951
2047,39009,Athens County, Ohio,28.2,65103,2903,1482,25,1457,686,171,515,439,255,184,296,236,60,17301,34221,18602,"Athens County, Ohio",9,39,26.57481222
2048,39011,Auglaize County, Ohio,41.2,45871,445,138,0,138,47,32,15,123,74,49,137,113,24,3973,55914,26690,"Auglaize County, Ohio",11,39,8.661245667
2049,39013,Belmont County, Ohio,44.1,69228,752,61,0,61,131,20,111,154,139,15,406,273,133,9839,44719,24533,"Belmont County, Ohio",13,39,14.21245739
2050,39015,Brown County, Ohio,41.1,44059,290,11,0,11,89,63,26,68,29,39,122,46,76,7179,47999,23776,"Brown County, Ohio",15,39,16.29406024
2051,39017,Butler County, Ohio,36.5,373638,20157,3473,289,3184,7847,2822,5025,4482,2575,1907,4355,3594,761,49134,59652,28556,"Butler County, Ohio",17,39,13.15016139
2052,39019,Carroll County, Ohio,44.7,28108,240,9,1,8,39,0,39,23,9,14,169,94,75,3873,48545,25093,"Carroll County, Ohio",19,39,13.7789953
2053,39021,Champaign County, Ohio,41.6,39175,355,54,0,54,90,61,29,45,40,5,166,88,78,4279,53673,24715,"Champaign County, Ohio",21,39,10.92278239
2054,39023,Clark County, Ohio,41.2,136175,2677,305,32,273,874,222,652,518,298,220,980,742,238,23792,44154,23992,"Clark County, Ohio",23,39,17.47163576
2055,39025,Clermont County, Ohio,39.7,201092,4160,514,0,514,1347,812,535,851,589,262,1448,1152,296,20968,61265,30060,"Clermont County, Ohio",25,39,10.42706821
2056,39027,Clinton County, Ohio,39.4,41854,460,70,13,57,102,22,80,103,61,42,185,173,12,6169,48675,23612,"Clinton County, Ohio",27,39,14.73933196
2057,39029,Columbiana County, Ohio,43.4,105230,1171,283,26,257,263,76,187,176,131,45,449,255,194,15946,45389,23785,"Columbiana County, Ohio",29,39,15.15347334
2058,39031,Coshocton County, Ohio,41.2,36665,202,27,0,27,59,42,17,26,8,18,90,90,0,5058,43380,21521,"Coshocton County, Ohio",31,39,13.79517251
2059,39033,Crawford County, Ohio,42.9,42485,407,130,7,123,118,16,102,54,53,1,105,80,25,6566,40563,22631,"Crawford County, Ohio",33,39,15.45486642
2060,39035,Cuyahoga County, Ohio,40.4,1258710,87819,14131,649,13482,21712,9736,11976,17972,14213,3759,34004,28985,5019,227740,45289,29143,"Cuyahoga County, Ohio",35,39,18.09312709
2061,39037,Darke County, Ohio,42,52185,499,80,0,80,175,88,87,123,90,33,121,86,35,6344,47043,23589,"Darke County, Ohio",37,39,12.15675002
2062,39039,Defiance County, Ohio,39.9,38488,695,201,74,127,171,109,62,88,50,38,235,213,22,5129,50822,24703,"Defiance County, Ohio",39,39,13.32623155
2063,39041,Delaware County, Ohio,38,188996,12323,1687,70,1617,3930,2109,1821,3477,2757,720,3229,2921,308,9034,94234,42985,"Delaware County, Ohio",41,39,4.779995344
2064,39043,Erie County, Ohio,44.5,75808,1592,192,0,192,294,78,216,199,97,102,907,752,155,9584,48276,28684,"Erie County, Ohio",43,39,12.64246518
2065,39045,Fairfield County, Ohio,39.3,150163,3974,803,25,778,773,413,360,994,893,101,1404,1097,307,15010,61473,28746,"Fairfield County, Ohio",45,39,9.995804559
2066,39047,Fayette County, Ohio,41.3,28719,419,74,16,58,209,80,129,84,0,84,52,45,7,5207,41954,22728,"Fayette County, Ohio",47,39,18.13085414
2067,39049,Franklin County, Ohio,33.9,1232118,121572,29576,2068,27508,47628,17324,30304,23508,15105,8403,20860,16555,4305,205186,54037,30098,"Franklin County, Ohio",49,39,16.65311277
2068,39051,Fulton County, Ohio,40,42466,651,118,0,118,246,145,101,105,67,38,182,112,70,4688,55860,27010,"Fulton County, Ohio",51,39,11.03941977
2069,39053,Gallia County, Ohio,40.5,30376,280,67,11,56,99,72,27,62,47,15,52,22,30,6334,39423,20914,"Gallia County, Ohio",53,39,20.85198841
2070,39055,Geauga County, Ohio,44.2,94020,2424,278,11,267,283,183,100,433,392,41,1430,1236,194,6399,74165,37537,"Geauga County, Ohio",55,39,6.805998724
2071,39057,Greene County, Ohio,38,164325,7793,2283,97,2186,1692,587,1105,1578,1179,399,2240,1890,350,19929,61116,31877,"Greene County, Ohio",57,39,12.12779553
2072,39059,Guernsey County, Ohio,42.3,39478,331,0,0,0,40,2,38,134,93,41,157,125,32,7722,41566,22280,"Guernsey County, Ohio",59,39,19.56026141
2073,39061,Hamilton County, Ohio,37,805965,40999,10079,430,9649,13857,4777,9080,7724,5028,2696,9339,7906,1433,140334,50399,31303,"Hamilton County, Ohio",61,39,17.41192235
2074,39063,Hancock County, Ohio,38.9,75672,2461,814,20,794,642,160,482,533,462,71,472,365,107,9877,51604,28244,"Hancock County, Ohio",63,39,13.05238397
2075,39065,Hardin County, Ohio,35.8,31652,487,54,0,54,273,22,251,113,62,51,47,37,10,4574,44842,20994,"Hardin County, Ohio",65,39,14.45090358
2076,39067,Harrison County, Ohio,46.2,15521,68,10,0,10,2,2,0,14,7,7,42,26,16,2756,44000,22639,"Harrison County, Ohio",67,39,17.75658785
2077,39069,Henry County, Ohio,41.4,27890,399,23,10,13,102,50,52,102,28,74,172,134,38,2783,54941,26288,"Henry County, Ohio",69,39,9.978486913
2078,39071,Highland County, Ohio,40.2,43109,343,47,0,47,145,46,99,71,40,31,80,44,36,8822,40593,21134,"Highland County, Ohio",71,39,20.46440418
2079,39073,Hocking County, Ohio,42.7,28690,293,18,0,18,79,8,71,82,11,71,114,46,68,4655,43382,22091,"Hocking County, Ohio",73,39,16.22516556
2080,39075,Holmes County, Ohio,30.6,43702,290,24,0,24,46,9,37,16,12,4,204,167,37,5504,53619,19517,"Holmes County, Ohio",75,39,12.59438927
2081,39077,Huron County, Ohio,39.4,58704,1595,143,0,143,866,95,771,206,103,103,380,304,76,7467,48838,23698,"Huron County, Ohio",77,39,12.71974652
2082,39079,Jackson County, Ohio,40.3,32717,410,124,0,124,66,35,31,75,53,22,145,95,50,7409,40330,20583,"Jackson County, Ohio",79,39,22.64571935
2083,39081,Jefferson County, Ohio,44.5,67607,867,94,0,94,146,55,91,93,60,33,534,433,101,11208,42327,23356,"Jefferson County, Ohio",81,39,16.57816498
2084,39083,Knox County, Ohio,39,60878,817,75,0,75,185,72,113,158,82,76,399,288,111,8958,48619,23426,"Knox County, Ohio",83,39,14.71467525
2085,39085,Lake County, Ohio,43.3,229266,12421,1510,201,1309,2851,909,1942,3020,1841,1179,5040,4269,771,19231,59958,31053,"Lake County, Ohio",85,39,8.388073242
2086,39087,Lawrence County, Ohio,41.4,61503,354,40,0,40,51,20,31,39,0,39,224,199,25,11183,44256,22567,"Lawrence County, Ohio",87,39,18.18285287
2087,39089,Licking County, Ohio,39.8,169762,3284,617,0,617,1091,716,375,728,459,269,848,643,205,20814,57571,27934,"Licking County, Ohio",89,39,12.26069438
2088,39091,Logan County, Ohio,41.2,45388,609,94,36,58,171,52,119,100,63,37,244,213,31,6258,51136,25877,"Logan County, Ohio",91,39,13.78778532
2089,39093,Lorain County, Ohio,41.2,304091,8823,1331,93,1238,2520,1359,1161,1250,889,361,3722,3149,573,41156,53459,27537,"Lorain County, Ohio",93,39,13.53410657
2090,39095,Lucas County, Ohio,37.9,434800,15264,2528,100,2428,4276,1781,2495,3102,2090,1012,5358,4337,1021,87717,42917,25977,"Lucas County, Ohio",95,39,20.17410304
2091,39097,Madison County, Ohio,40.2,43537,664,213,0,213,99,21,78,155,115,40,197,163,34,4061,58326,25687,"Madison County, Ohio",97,39,9.32769828
2092,39099,Mahoning County, Ohio,43.4,233015,6637,861,27,834,1453,415,1038,1348,736,612,2975,2290,685,40823,41872,24651,"Mahoning County, Ohio",99,39,17.519473
2093,39101,Marion County, Ohio,40.5,65620,914,85,16,69,330,83,247,242,109,133,257,187,70,10299,43557,21177,"Marion County, Ohio",101,39,15.69491009
2094,39103,Medina County, Ohio,41.8,175543,4868,414,42,372,997,656,341,917,780,137,2540,2154,386,11532,69319,32911,"Medina County, Ohio",103,39,6.569330591
2095,39105,Meigs County, Ohio,42.8,23345,67,4,0,4,20,0,20,27,8,19,16,16,0,5247,39640,21317,"Meigs County, Ohio",105,39,22.4759049
2096,39107,Mercer County, Ohio,40,40886,370,86,13,73,148,23,125,15,15,0,121,78,43,3347,55220,26236,"Mercer County, Ohio",107,39,8.186176197
2097,39109,Miami County, Ohio,41.4,103864,1732,503,15,488,374,195,179,306,190,116,549,428,121,11374,53432,27247,"Miami County, Ohio",109,39,10.95085882
2098,39111,Monroe County, Ohio,46.3,14442,69,6,0,6,14,14,0,31,31,0,18,9,9,2679,41368,22100,"Monroe County, Ohio",111,39,18.55006232
2099,39113,Montgomery County, Ohio,39.4,532761,23030,4892,413,4479,8624,4018,4606,3581,2622,959,5933,4892,1041,95684,45394,26392,"Montgomery County, Ohio",113,39,17.96002335
2100,39115,Morgan County, Ohio,43.8,14857,76,12,0,12,14,0,14,11,0,11,39,25,14,2936,38941,20301,"Morgan County, Ohio",115,39,19.76172848
2101,39117,Morrow County, Ohio,41.5,35032,123,17,0,17,7,6,1,10,10,0,89,89,0,3816,53032,23630,"Morrow County, Ohio",117,39,10.89289792
2102,39119,Muskingum County, Ohio,40.2,85991,1049,292,23,269,218,58,160,142,51,91,397,285,112,14564,42464,21945,"Muskingum County, Ohio",119,39,16.93665616
2103,39121,Noble County, Ohio,47.9,14429,110,8,0,8,45,0,45,0,0,0,57,57,0,1409,41398,21188,"Noble County, Ohio",121,39,9.765056483
2104,39123,Ottawa County, Ohio,47.8,40981,338,10,0,10,66,54,12,33,13,20,229,188,41,4464,54580,30403,"Ottawa County, Ohio",123,39,10.89285279
2105,39125,Paulding County, Ohio,41.3,19057,274,31,0,31,129,16,113,42,14,28,72,44,28,2083,48003,24174,"Paulding County, Ohio",125,39,10.93036679
2106,39127,Perry County, Ohio,39.8,35947,219,41,0,41,99,69,30,31,31,0,48,48,0,7322,43674,20852,"Perry County, Ohio",127,39,20.3688764
2107,39129,Pickaway County, Ohio,39.3,56804,588,67,20,47,281,234,47,37,0,37,203,188,15,6324,58706,24779,"Pickaway County, Ohio",129,39,11.1330188
2108,39131,Pike County, Ohio,40.8,28298,150,0,0,0,68,7,61,33,33,0,49,32,17,5735,41128,21375,"Pike County, Ohio",131,39,20.26644993
2109,39133,Portage County, Ohio,37.7,161796,6449,2996,4,2992,1096,341,755,747,492,255,1610,1217,393,23293,52427,26769,"Portage County, Ohio",133,39,14.39652402
2110,39135,Preble County, Ohio,42.2,41561,457,146,0,146,102,47,55,25,20,5,184,118,66,5536,51356,24605,"Preble County, Ohio",135,39,13.32017998
2111,39137,Putnam County, Ohio,39.4,34116,285,16,16,0,66,28,38,69,29,40,134,111,23,2648,60245,27367,"Putnam County, Ohio",137,39,7.761754016
2112,39139,Richland County, Ohio,41.2,121888,1845,252,0,252,358,175,183,279,147,132,956,793,163,18849,42849,22520,"Richland County, Ohio",139,39,15.46419664
2113,39141,Ross County, Ohio,40.4,77193,666,65,14,51,264,86,178,93,62,31,244,203,41,13419,44587,22158,"Ross County, Ohio",141,39,17.38370059
2114,39143,Sandusky County, Ohio,41.5,59870,917,41,17,24,171,82,89,290,99,191,415,315,100,7757,49032,24467,"Sandusky County, Ohio",143,39,12.95640555
2115,39145,Scioto County, Ohio,39.7,77366,788,132,0,132,321,93,228,109,88,21,226,174,52,17569,37936,20728,"Scioto County, Ohio",145,39,22.70894191
2116,39147,Seneca County, Ohio,39.4,55711,731,255,0,255,154,34,120,120,38,82,202,124,78,8209,48415,23900,"Seneca County, Ohio",147,39,14.73497155
2117,39149,Shelby County, Ohio,39.5,48949,821,309,38,271,134,32,102,162,55,107,216,195,21,4600,56169,27330,"Shelby County, Ohio",149,39,9.397536211
2118,39151,Stark County, Ohio,41.7,374762,7724,827,89,738,1963,666,1297,1612,970,642,3322,2823,499,51534,48714,26442,"Stark County, Ohio",151,39,13.75112738
2119,39153,Summit County, Ohio,40.8,541372,26222,5528,197,5331,8458,2950,5508,4581,3531,1050,7655,6282,1373,75894,51562,29643,"Summit County, Ohio",153,39,14.01882624
2120,39155,Trumbull County, Ohio,43.8,204908,2903,99,8,91,446,142,304,337,293,44,2021,1636,385,35115,43811,24445,"Trumbull County, Ohio",155,39,17.13695903
2121,39157,Tuscarawas County, Ohio,40.9,92579,1528,373,31,342,612,130,482,303,251,52,240,202,38,12379,46992,24173,"Tuscarawas County, Ohio",157,39,13.3712829
2122,39159,Union County, Ohio,38.2,53955,1780,327,33,294,401,138,263,491,388,103,561,491,70,3965,71282,30431,"Union County, Ohio",159,39,7.348716523
2123,39161,Van Wert County, Ohio,41.4,28501,263,46,0,46,87,34,53,62,21,41,68,48,20,3449,50547,25316,"Van Wert County, Ohio",161,39,12.10132978
2124,39163,Vinton County, Ohio,41,13128,22,0,0,0,0,0,0,0,0,0,22,12,10,2767,41080,19431,"Vinton County, Ohio",163,39,21.07708714
2125,39165,Warren County, Ohio,39.1,222184,13481,2419,193,2226,4626,1768,2858,3589,2323,1266,2847,2517,330,11581,76200,36057,"Warren County, Ohio",165,39,5.212346524
2126,39167,Washington County, Ohio,43.6,61154,875,222,25,197,235,113,122,243,140,103,175,138,37,9275,44763,25462,"Washington County, Ohio",167,39,15.16662851
2127,39169,Wayne County, Ohio,38.8,115747,2394,529,14,515,889,298,591,311,265,46,665,518,147,14207,51363,24311,"Wayne County, Ohio",169,39,12.27418421
2128,39171,Williams County, Ohio,41.6,37270,497,19,7,12,189,57,132,138,101,37,151,120,31,5176,45044,22757,"Williams County, Ohio",171,39,13.88784545
2129,39173,Wood County, Ohio,34.7,129418,4074,1066,143,923,904,388,516,1005,586,419,1099,887,212,16797,55985,28843,"Wood County, Ohio",173,39,12.97887465
2130,39175,Wyandot County, Ohio,41.7,22359,344,32,0,32,132,68,64,71,0,71,109,107,2,2440,50723,25064,"Wyandot County, Ohio",175,39,10.91283152
2131,40001,Adair County, Oklahoma,37.1,22161,489,28,2,26,181,43,138,126,38,88,154,74,80,6595,33184,16018,"Adair County, Oklahoma",1,40,29.75948739
2132,40003,Alfalfa County, Oklahoma,44.1,5784,155,14,0,14,32,0,32,49,10,39,60,24,36,589,52226,27807,"Alfalfa County, Oklahoma",3,40,10.18326418
2133,40005,Atoka County, Oklahoma,40.7,13847,199,33,6,27,85,57,28,36,10,26,45,28,17,2690,36528,19159,"Atoka County, Oklahoma",5,40,19.4265906
2134,40007,Beaver County, Oklahoma,41,5479,538,67,0,67,66,5,61,285,76,209,120,94,26,547,52908,26738,"Beaver County, Oklahoma",7,40,9.983573645
2135,40009,Beckham County, Oklahoma,34.9,23290,710,106,0,106,244,28,216,123,23,100,237,210,27,3030,48851,25269,"Beckham County, Oklahoma",9,40,13.00987548
2136,40011,Blaine County, Oklahoma,41.7,9777,483,89,9,80,47,0,47,174,0,174,173,95,78,1144,44216,20848,"Blaine County, Oklahoma",11,40,11.70093076
2137,40013,Bryan County, Oklahoma,37.5,44529,941,189,20,169,383,76,307,237,134,103,132,90,42,7551,39936,21273,"Bryan County, Oklahoma",13,40,16.95748838
2138,40015,Caddo County, Oklahoma,37.2,29510,1134,198,14,184,350,114,236,290,51,239,296,132,164,5883,40199,20499,"Caddo County, Oklahoma",15,40,19.93561505
2139,40017,Canadian County, Oklahoma,35.7,129571,6161,719,42,677,1684,652,1032,1932,1257,675,1826,1362,464,10237,66664,28724,"Canadian County, Oklahoma",17,40,7.900687654
2140,40019,Carter County, Oklahoma,38.2,48530,1390,162,19,143,521,92,429,282,108,174,425,344,81,7395,46913,24272,"Carter County, Oklahoma",19,40,15.23799712
2141,40021,Cherokee County, Oklahoma,34.9,48267,1384,279,0,279,354,41,313,455,81,374,296,213,83,10380,38585,19627,"Cherokee County, Oklahoma",21,40,21.50537634
2142,40023,Choctaw County, Oklahoma,42.4,15051,160,3,0,3,65,23,42,34,23,11,58,36,22,4230,30870,19085,"Choctaw County, Oklahoma",23,40,28.10444489
2143,40025,Cimarron County, Oklahoma,44.6,2269,220,16,0,16,57,7,50,67,13,54,80,42,38,351,44550,26309,"Cimarron County, Oklahoma",25,40,15.46936977
2144,40027,Cleveland County, Oklahoma,33.4,271818,16549,3255,182,3073,4448,1747,2701,4154,2463,1691,4692,3729,963,32583,58488,28378,"Cleveland County, Oklahoma",27,40,11.98706487
2145,40029,Coal County, Oklahoma,42.4,5755,50,0,0,0,17,3,14,17,17,0,16,8,8,1112,39231,23716,"Coal County, Oklahoma",29,40,19.32232841
2146,40031,Comanche County, Oklahoma,32,124583,6669,939,48,891,1469,495,974,1146,620,526,3115,2429,686,19294,47238,23925,"Comanche County, Oklahoma",31,40,15.48686418
2147,40033,Cotton County, Oklahoma,41,6062,14,0,0,0,3,3,0,0,0,0,11,6,5,956,48732,22411,"Cotton County, Oklahoma",33,40,15.77037281
2148,40035,Craig County, Oklahoma,42.6,14683,270,20,9,11,60,6,54,78,16,62,112,82,30,2458,40036,20130,"Craig County, Oklahoma",35,40,16.74044814
2149,40037,Creek County, Oklahoma,40.6,70931,1348,156,32,124,406,162,244,267,154,113,519,308,211,10491,46517,23336,"Creek County, Oklahoma",37,40,14.79043014
2150,40039,Custer County, Oklahoma,30.5,29248,2018,449,0,449,727,116,611,345,127,218,497,251,246,4459,47250,23540,"Custer County, Oklahoma",39,40,15.24548687
2151,40041,Delaware County, Oklahoma,46.2,41433,923,83,10,73,191,91,100,248,108,140,401,234,167,8086,38438,22267,"Delaware County, Oklahoma",41,40,19.51584486
2152,40043,Dewey County, Oklahoma,40.6,4862,107,47,0,47,49,8,41,3,0,3,8,5,3,855,51654,25708,"Dewey County, Oklahoma",43,40,17.58535582
2153,40045,Ellis County, Oklahoma,43.9,4123,91,18,0,18,39,0,39,7,0,7,27,16,11,627,52222,28610,"Ellis County, Oklahoma",45,40,15.20737327
2154,40047,Garfield County, Oklahoma,36,62481,4640,432,80,352,2137,434,1703,889,358,531,1182,666,516,7980,49675,24968,"Garfield County, Oklahoma",47,40,12.77188265
2155,40049,Garvin County, Oklahoma,39.5,27570,846,216,0,216,232,57,175,187,49,138,211,169,42,5070,41250,22208,"Garvin County, Oklahoma",49,40,18.38955386
2156,40051,Grady County, Oklahoma,38.4,53955,1044,221,74,147,282,140,142,103,49,54,438,281,157,6759,54043,26250,"Grady County, Oklahoma",51,40,12.52710592
2157,40053,Grant County, Oklahoma,45,4497,64,0,0,0,6,1,5,35,34,1,23,19,4,401,54040,29559,"Grant County, Oklahoma",53,40,8.917055815
2158,40055,Greer County, Oklahoma,41,6081,31,0,0,0,3,0,3,1,1,0,27,10,17,957,36891,20147,"Greer County, Oklahoma",55,40,15.73754317
2159,40057,Harmon County, Oklahoma,41.1,2813,173,60,43,17,68,14,54,20,8,12,25,11,14,433,35676,21227,"Harmon County, Oklahoma",57,40,15.39281905
2160,40059,Harper County, Oklahoma,39.9,3785,610,298,7,291,175,10,165,75,19,56,62,27,35,522,48173,24948,"Harper County, Oklahoma",59,40,13.79128137
2161,40061,Haskell County, Oklahoma,40.4,12835,196,42,0,42,89,0,89,19,2,17,46,17,29,2574,36067,18981,"Haskell County, Oklahoma",61,40,20.05453837
2162,40063,Hughes County, Oklahoma,39.9,13727,137,24,0,24,50,8,42,7,0,7,56,56,0,2373,35257,16672,"Hughes County, Oklahoma",63,40,17.28709842
2163,40065,Jackson County, Oklahoma,34.3,25864,1777,360,47,313,442,128,314,430,177,253,545,362,183,4206,44331,23616,"Jackson County, Oklahoma",65,40,16.26198577
2164,40067,Jefferson County, Oklahoma,42.1,6280,184,13,0,13,12,4,8,39,21,18,120,71,49,1195,35063,19651,"Jefferson County, Oklahoma",67,40,19.02866242
2165,40069,Johnston County, Oklahoma,40.1,11027,92,2,0,2,36,27,9,23,8,15,31,17,14,2272,38155,19602,"Johnston County, Oklahoma",69,40,20.60397207
2166,40071,Kay County, Oklahoma,38.6,45398,1248,155,4,151,357,74,283,170,100,70,566,399,167,7919,42831,23514,"Kay County, Oklahoma",71,40,17.44349971
2167,40073,Kingfisher County, Oklahoma,38.3,15392,1184,138,0,138,331,3,328,364,85,279,351,194,157,1279,62912,30011,"Kingfisher County, Oklahoma",73,40,8.309511435
2168,40075,Kiowa County, Oklahoma,43.3,9239,162,35,0,35,38,24,14,45,0,45,44,28,16,1938,38853,22857,"Kiowa County, Oklahoma",75,40,20.97629614
2169,40077,Latimer County, Oklahoma,39,10643,135,18,0,18,46,27,19,16,16,0,55,35,20,1957,39701,22560,"Latimer County, Oklahoma",77,40,18.38767265
2170,40079,Le Flore County, Oklahoma,39.7,49885,1764,312,32,280,574,45,529,583,115,468,295,196,99,11061,37548,19138,"Le Flore County, Oklahoma",79,40,22.1729979
2171,40081,Lincoln County, Oklahoma,41.1,34640,278,20,0,20,41,7,34,106,34,72,111,87,24,5125,46592,23878,"Lincoln County, Oklahoma",81,40,14.79503464
2172,40083,Logan County, Oklahoma,37.8,45171,1152,111,0,111,247,101,146,253,131,122,541,397,144,5382,55698,27483,"Logan County, Oklahoma",83,40,11.91472405
2173,40085,Love County, Oklahoma,39.2,9768,468,22,0,22,145,2,143,136,39,97,165,67,98,1219,46646,20440,"Love County, Oklahoma",85,40,12.47952498
2174,40087,McClain County, Oklahoma,38.3,37222,1008,47,8,39,284,80,204,295,87,208,382,253,129,3530,58673,27217,"McClain County, Oklahoma",87,40,9.483638708
2175,40089,McCurtain County, Oklahoma,38.9,33071,778,190,59,131,208,32,176,162,72,90,218,155,63,7705,33439,18507,"McCurtain County, Oklahoma",89,40,23.29835808
2176,40091,McIntosh County, Oklahoma,47.4,20161,163,18,0,18,18,0,18,33,10,23,94,73,21,3757,36878,21456,"McIntosh County, Oklahoma",91,40,18.63498834
2177,40093,Major County, Oklahoma,41.2,7721,319,42,24,18,73,31,42,120,39,81,84,60,24,1031,51602,27797,"Major County, Oklahoma",93,40,13.35319259
2178,40095,Marshall County, Oklahoma,42.6,16079,1026,122,0,122,257,22,235,478,104,374,169,35,134,2613,42886,21394,"Marshall County, Oklahoma",95,40,16.25101063
2179,40097,Mayes County, Oklahoma,39.7,40923,426,32,0,32,108,20,88,89,36,53,197,87,110,8454,43302,21756,"Mayes County, Oklahoma",97,40,20.65830951
2180,40099,Murray County, Oklahoma,42,13792,375,95,0,95,72,19,53,64,41,23,144,138,6,1925,51752,24454,"Murray County, Oklahoma",99,40,13.95736659
2181,40101,Muskogee County, Oklahoma,37.8,69939,1905,148,28,120,764,81,683,558,241,317,435,286,149,14085,41117,21109,"Muskogee County, Oklahoma",101,40,20.13897825
2182,40103,Noble County, Oklahoma,41.5,11470,66,10,5,5,0,0,0,4,4,0,52,18,34,1449,49367,26701,"Noble County, Oklahoma",103,40,12.63295554
2183,40105,Nowata County, Oklahoma,42,10510,127,10,1,9,41,20,21,23,8,15,53,27,26,1941,40302,21085,"Nowata County, Oklahoma",105,40,18.46812559
2184,40107,Okfuskee County, Oklahoma,39.9,12212,187,32,12,20,25,14,11,27,11,16,103,85,18,2957,36044,17381,"Okfuskee County, Oklahoma",107,40,24.21388798
2185,40109,Oklahoma County, Oklahoma,34.3,764698,81564,13458,554,12904,30945,6021,24924,19902,6412,13490,17259,11438,5821,132442,48987,28059,"Oklahoma County, Oklahoma",109,40,17.31951699
2186,40111,Okmulgee County, Oklahoma,39.1,39322,395,21,0,21,96,18,78,48,30,18,230,141,89,7656,38712,20721,"Okmulgee County, Oklahoma",111,40,19.47001678
2187,40113,Osage County, Oklahoma,42,47923,715,64,0,64,117,16,101,149,53,96,385,308,77,6948,46342,23416,"Osage County, Oklahoma",113,40,14.49825762
2188,40115,Ottawa County, Oklahoma,38.4,32022,673,69,17,52,243,40,203,145,53,92,216,142,74,6957,37139,18616,"Ottawa County, Oklahoma",115,40,21.72568859
2189,40117,Pawnee County, Oklahoma,41.9,16444,200,49,0,49,40,19,21,33,33,0,78,57,21,2360,45902,22750,"Pawnee County, Oklahoma",117,40,14.35173924
2190,40119,Payne County, Oklahoma,27.1,79953,5178,2575,28,2547,1292,95,1197,569,269,300,742,561,181,18943,38085,22409,"Payne County, Oklahoma",119,40,23.69266944
2191,40121,Pittsburg County, Oklahoma,40.8,44643,911,88,6,82,339,113,226,301,110,191,183,136,47,7450,43601,23339,"Pittsburg County, Oklahoma",121,40,16.6879466
2192,40123,Pontotoc County, Oklahoma,35.3,38213,989,148,9,139,433,141,292,169,102,67,239,164,75,6661,44041,22710,"Pontotoc County, Oklahoma",123,40,17.43124068
2193,40125,Pottawatomie County, Oklahoma,37.5,71551,1211,208,16,192,462,142,320,148,66,82,393,303,90,12334,44351,21422,"Pottawatomie County, Oklahoma",125,40,17.23805398
2194,40127,Pushmataha County, Oklahoma,44.9,11149,139,2,0,2,85,0,85,8,2,6,44,37,7,2414,33784,22207,"Pushmataha County, Oklahoma",127,40,21.65216611
2195,40129,Roger Mills County, Oklahoma,40.2,3732,38,0,0,0,25,3,22,0,0,0,13,9,4,473,48462,27869,"Roger Mills County, Oklahoma",129,40,12.67416935
2196,40131,Rogers County, Oklahoma,38.9,89970,2088,233,13,220,609,166,443,489,230,259,757,562,195,8297,59828,28938,"Rogers County, Oklahoma",131,40,9.221962877
2197,40133,Seminole County, Oklahoma,39.4,25403,345,36,0,36,105,16,89,96,38,58,108,71,37,5615,36870,19374,"Seminole County, Oklahoma",133,40,22.10368854
2198,40135,Sequoyah County, Oklahoma,40,41344,676,153,11,142,162,89,73,155,29,126,206,114,92,10157,36301,18698,"Sequoyah County, Oklahoma",135,40,24.56704721
2199,40137,Stephens County, Oklahoma,40.2,44631,1169,172,6,166,253,80,173,344,122,222,400,255,145,6798,43493,24555,"Stephens County, Oklahoma",137,40,15.2315655
2200,40139,Texas County, Oklahoma,32,21499,5080,343,15,328,2344,57,2287,1100,243,857,1293,436,857,2814,51503,22923,"Texas County, Oklahoma",139,40,13.08898088
2201,40141,Tillman County, Oklahoma,40.8,7611,417,94,0,94,104,21,83,120,27,93,99,61,38,1581,37880,20549,"Tillman County, Oklahoma",141,40,20.77256602
2202,40143,Tulsa County, Oklahoma,35.4,629823,53049,9148,285,8863,19771,3238,16533,12459,4523,7936,11671,8119,3552,98682,50654,28970,"Tulsa County, Oklahoma",143,40,15.66821155
2203,40145,Wagoner County, Oklahoma,38.5,76190,2550,198,37,161,847,209,638,646,228,418,859,574,285,8206,57590,26159,"Wagoner County, Oklahoma",145,40,10.77044232
2204,40147,Washington County, Oklahoma,40.4,51892,2147,616,9,607,598,131,467,517,190,327,416,300,116,7325,50038,28528,"Washington County, Oklahoma",147,40,14.11585601
2205,40149,Washita County, Oklahoma,38.5,11626,313,20,0,20,116,1,115,53,4,49,124,68,56,1803,48715,25032,"Washita County, Oklahoma",149,40,15.50834337
2206,40151,Woods County, Oklahoma,33.6,9125,233,30,23,7,106,35,71,25,21,4,72,31,41,1059,57079,27464,"Woods County, Oklahoma",151,40,11.60547945
2207,40153,Woodward County, Oklahoma,36.1,21111,868,158,0,158,275,25,250,143,20,123,292,115,177,2568,58569,27308,"Woodward County, Oklahoma",153,40,12.16427455
2208,41001,Baker County, Oregon,48.2,16030,306,52,13,39,91,30,61,75,20,55,88,55,33,2339,41722,24776,"Baker County, Oregon",1,41,14.59139114
2209,41003,Benton County, Oregon,32.6,87455,8316,2698,137,2561,1810,355,1455,1633,697,936,2175,1555,620,17665,52015,28986,"Benton County, Oregon",3,41,20.19895946
2210,41005,Clackamas County, Oregon,41.4,394967,31787,2406,269,2137,7203,2810,4393,9709,4802,4907,12469,9633,2836,36160,68915,35506,"Clackamas County, Oregon",5,41,9.155195244
2211,41007,Clatsop County, Oregon,43.7,37660,1839,144,24,120,791,36,755,242,68,174,662,353,309,5187,47492,27071,"Clatsop County, Oregon",7,41,13.7732342
2212,41009,Columbia County, Oregon,43.3,49645,1542,149,0,149,424,86,338,306,101,205,663,515,148,6598,55146,27449,"Columbia County, Oregon",9,41,13.29036157
2213,41011,Coos County, Oregon,48.2,62944,2363,316,0,316,427,122,305,573,103,470,1047,765,282,11213,39110,24261,"Coos County, Oregon",11,41,17.81424759
2214,41013,Crook County, Oregon,48.3,21334,396,1,0,1,64,12,52,90,0,90,241,154,87,3757,39583,22346,"Crook County, Oregon",13,41,17.61038718
2215,41015,Curry County, Oregon,55.1,22364,790,16,0,16,32,21,11,208,103,105,534,362,172,3382,38661,24908,"Curry County, Oregon",15,41,15.12251833
2216,41017,Deschutes County, Oregon,42,170813,7079,502,37,465,2013,346,1667,1681,512,1169,2883,1784,1099,23622,54211,30177,"Deschutes County, Oregon",17,41,13.8291582
2217,41019,Douglas County, Oregon,47,107375,2938,277,27,250,687,201,486,519,218,301,1455,1061,394,19701,42052,23608,"Douglas County, Oregon",19,41,18.34784633
2218,41021,Gilliam County, Oregon,46.5,1913,50,5,0,5,0,0,0,8,8,0,37,17,20,213,40556,23360,"Gilliam County, Oregon",21,41,11.13434396
2219,41023,Grant County, Oregon,52.4,7227,170,9,0,9,7,2,5,40,6,34,114,112,2,1059,40193,23960,"Grant County, Oregon",23,41,14.65338315
2220,41025,Harney County, Oregon,46.1,7214,158,41,0,41,25,0,25,8,5,3,84,52,32,1166,38431,22795,"Harney County, Oregon",25,41,16.16301636
2221,41027,Hood River County, Oregon,39.1,22842,3442,263,33,230,869,64,805,913,112,801,1397,453,944,3006,56581,28347,"Hood River County, Oregon",27,41,13.15996848
2222,41029,Jackson County, Oregon,42.9,210916,12496,807,72,735,3417,527,2890,3129,1021,2108,5143,3230,1913,37595,46343,25612,"Jackson County, Oregon",29,41,17.82463161
2223,41031,Jefferson County, Oregon,40.2,22305,1599,10,0,10,267,53,214,541,133,408,781,318,463,4355,47063,21630,"Jefferson County, Oregon",31,41,19.52477023
2224,41033,Josephine County, Oregon,47.9,84063,3085,219,8,211,958,146,812,305,188,117,1603,1075,528,16177,37867,23004,"Josephine County, Oregon",33,41,19.24390041
2225,41035,Klamath County, Oregon,42.6,65946,3367,190,67,123,791,185,606,1000,301,699,1386,904,482,12117,41951,23071,"Klamath County, Oregon",35,41,18.37412428
2226,41037,Lake County, Oregon,48.7,7799,277,29,0,29,29,0,29,125,7,118,94,83,11,1280,33453,20327,"Lake County, Oregon",37,41,16.41236056
2227,41039,Lane County, Oregon,39.3,360273,21211,3564,73,3491,5252,1182,4070,5132,1840,3292,7263,5157,2106,69588,45222,25612,"Lane County, Oregon",39,41,19.31535252
2228,41041,Lincoln County, Oregon,50.7,46685,2704,282,52,230,577,80,497,779,165,614,1066,698,368,8576,41303,24593,"Lincoln County, Oregon",41,41,18.3699261
2229,41043,Linn County, Oregon,39.5,119862,4926,304,66,238,1173,267,906,1545,396,1149,1904,1183,721,20561,46782,22934,"Linn County, Oregon",43,41,17.15389364
2230,41045,Malheur County, Oregon,36.4,30474,3259,169,5,164,848,127,721,1016,86,930,1226,557,669,6651,34720,17150,"Malheur County, Oregon",45,41,21.82516243
2231,41047,Marion County, Oregon,36,326527,42380,2715,423,2292,13326,1715,11611,13047,4061,8986,13292,7372,5920,54411,50775,23348,"Marion County, Oregon",47,41,16.66355309
2232,41049,Morrow County, Oregon,37.4,11207,1906,100,22,78,506,30,476,700,115,585,600,243,357,1694,54441,21279,"Morrow County, Oregon",49,41,15.11555278
2233,41051,Multnomah County, Oregon,36.7,778193,108386,18236,1303,16933,30769,9997,20772,31034,15827,15207,28347,21634,6713,130564,57449,33255,"Multnomah County, Oregon",51,41,16.77784303
2234,41053,Polk County, Oregon,37.3,78470,6428,767,0,767,1390,450,940,2138,993,1145,2133,1246,887,11916,54010,24827,"Polk County, Oregon",53,41,15.18542118
2235,41055,Sherman County, Oregon,50.1,1705,36,6,0,6,19,0,19,3,3,0,8,2,6,301,41389,32223,"Sherman County, Oregon",55,41,17.65395894
2236,41057,Tillamook County, Oregon,48.1,25552,1348,53,0,53,357,66,291,439,95,344,499,249,250,3821,43777,23688,"Tillamook County, Oregon",57,41,14.95381966
2237,41059,Umatilla County, Oregon,35.9,76582,8357,597,6,591,2719,230,2489,2272,442,1830,2769,1515,1254,12918,49287,21528,"Umatilla County, Oregon",59,41,16.86819357
2238,41061,Union County, Oregon,39.7,25758,924,100,0,100,455,34,421,173,73,100,196,146,50,4655,45564,25458,"Union County, Oregon",61,41,18.07205528
2239,41063,Wallowa County, Oregon,52.7,6836,102,0,0,0,21,0,21,15,12,3,66,60,6,980,42349,24956,"Wallowa County, Oregon",63,41,14.33586893
2240,41065,Wasco County, Oregon,41.6,25657,1938,85,0,85,668,104,564,618,68,550,567,306,261,3651,46814,22931,"Wasco County, Oregon",65,41,14.23003469
2241,41067,Washington County, Oregon,36.2,564088,95679,13048,1108,11940,29002,7362,21640,25880,11921,13959,27749,21046,6703,61817,69743,33433,"Washington County, Oregon",67,41,10.95875112
2242,41069,Wheeler County, Oregon,59.2,1369,15,1,0,1,4,0,4,1,1,0,9,4,5,272,33400,22723,"Wheeler County, Oregon",69,41,19.86851717
2243,41071,Yamhill County, Oregon,38.1,102217,9014,702,27,675,3021,362,2659,2490,931,1559,2801,1831,970,15255,54951,26523,"Yamhill County, Oregon",71,41,14.92413199
2244,42001,Adams County, Pennsylvania,43.1,101759,4048,510,81,429,1396,246,1150,947,350,597,1195,903,292,9117,61927,28515,"Adams County, Pennsylvania",1,42,8.959404082
2245,42003,Allegheny County, Pennsylvania,40.8,1230360,69149,18705,611,18094,20080,6779,13301,12577,9273,3304,17787,14622,3165,152390,54357,33830,"Allegheny County, Pennsylvania",3,42,12.38580578
2246,42005,Armstrong County, Pennsylvania,46,67512,433,41,0,41,111,40,71,53,35,18,228,199,29,8786,45879,24634,"Armstrong County, Pennsylvania",5,42,13.0139827
2247,42007,Beaver County, Pennsylvania,44.8,169205,2787,137,7,130,546,321,225,487,319,168,1617,1322,295,18036,51887,28018,"Beaver County, Pennsylvania",7,42,10.65925948
2248,42009,Bedford County, Pennsylvania,45.4,48852,264,48,5,43,67,23,44,22,19,3,127,78,49,6846,46746,23632,"Bedford County, Pennsylvania",9,42,14.01375583
2249,42011,Berks County, Pennsylvania,39.8,414097,29202,3783,419,3364,8514,2835,5679,7563,3783,3780,9342,7170,2172,57329,57068,27844,"Berks County, Pennsylvania",11,42,13.84434082
2250,42013,Blair County, Pennsylvania,43.1,125917,1448,173,37,136,310,174,136,427,329,98,538,450,88,18196,44033,24466,"Blair County, Pennsylvania",13,42,14.45078901
2251,42015,Bradford County, Pennsylvania,44.3,61808,829,156,32,124,106,62,44,143,106,37,424,335,89,7562,51035,26255,"Bradford County, Pennsylvania",15,42,12.23466218
2252,42017,Bucks County, Pennsylvania,43.3,626220,53405,5554,490,5064,14343,5604,8739,14888,11013,3875,18620,16514,2106,36635,79559,39958,"Bucks County, Pennsylvania",17,42,5.850180448
2253,42019,Butler County, Pennsylvania,43,185974,3782,461,52,409,1213,487,726,673,443,230,1435,1215,220,15257,63345,33406,"Butler County, Pennsylvania",19,42,8.203834945
2254,42021,Cambria County, Pennsylvania,44.7,137762,1611,259,8,251,310,94,216,314,222,92,728,551,177,20274,42917,23993,"Cambria County, Pennsylvania",21,42,14.7166853
2255,42023,Cameron County, Pennsylvania,50.4,4807,87,40,8,32,5,2,3,25,23,2,17,17,0,602,40347,25716,"Cameron County, Pennsylvania",23,42,12.52340337
2256,42025,Carbon County, Pennsylvania,45.5,64330,1724,80,0,80,426,217,209,258,153,105,960,870,90,7621,50822,25743,"Carbon County, Pennsylvania",25,42,11.84672781
2257,42027,Centre County, Pennsylvania,30.8,159178,12903,6090,242,5848,3537,1141,2396,1706,1073,633,1570,1371,199,27170,54407,27584,"Centre County, Pennsylvania",27,42,17.06894169
2258,42029,Chester County, Pennsylvania,40.3,512028,47128,7868,630,7238,17328,4255,13073,9753,5753,4000,12179,9592,2587,35883,88995,44299,"Chester County, Pennsylvania",29,42,7.008015187
2259,42031,Clarion County, Pennsylvania,40.8,38939,396,60,0,60,169,80,89,41,38,3,126,116,10,6941,42890,22451,"Clarion County, Pennsylvania",31,42,17.82531652
2260,42033,Clearfield County, Pennsylvania,43.9,81170,2412,298,18,280,544,50,494,723,159,564,847,309,538,11196,43361,21650,"Clearfield County, Pennsylvania",33,42,13.79327338
2261,42035,Clinton County, Pennsylvania,37.9,39536,546,61,10,51,182,34,148,152,112,40,151,105,46,6436,47163,22084,"Clinton County, Pennsylvania",35,42,16.27883448
2262,42037,Columbia County, Pennsylvania,40.1,66772,1542,130,31,99,557,238,319,322,169,153,533,377,156,9498,46952,24155,"Columbia County, Pennsylvania",37,42,14.22452525
2263,42039,Crawford County, Pennsylvania,42.6,87027,1032,215,32,183,218,71,147,214,128,86,385,287,98,12077,45637,23578,"Crawford County, Pennsylvania",39,42,13.87730245
2264,42041,Cumberland County, Pennsylvania,40.7,243838,14322,2839,115,2724,4963,1993,2970,3152,2380,772,3368,2836,532,19828,62640,33079,"Cumberland County, Pennsylvania",41,42,8.131628376
2265,42043,Dauphin County, Pennsylvania,39.6,271962,19560,4682,279,4403,6119,2622,3497,3969,2841,1128,4790,3948,842,35950,54968,30068,"Dauphin County, Pennsylvania",43,42,13.2187585
2266,42045,Delaware County, Pennsylvania,39,562316,54696,8040,730,7310,18443,7342,11101,11870,8403,3467,16343,14028,2315,58737,66576,34857,"Delaware County, Pennsylvania",45,42,10.44555019
2267,42047,Elk County, Pennsylvania,46.6,31111,289,12,0,12,83,48,35,83,69,14,111,98,13,2688,47917,25753,"Elk County, Pennsylvania",47,42,8.640030857
2268,42049,Erie County, Pennsylvania,38.9,279133,12625,3406,152,3254,4242,1726,2516,2204,1446,758,2773,2359,414,44452,47094,25555,"Erie County, Pennsylvania",49,42,15.92502499
2269,42051,Fayette County, Pennsylvania,44.4,134229,1218,364,35,329,131,46,85,190,129,61,533,382,151,24277,40511,22863,"Fayette County, Pennsylvania",51,42,18.08625558
2270,42053,Forest County, Pennsylvania,42.8,7493,176,1,0,1,31,24,7,70,28,42,74,46,28,387,36594,13283,"Forest County, Pennsylvania",53,42,5.164820499
2271,42055,Franklin County, Pennsylvania,40.9,152707,4962,653,52,601,1684,346,1338,1013,505,508,1612,1176,436,17504,55751,27706,"Franklin County, Pennsylvania",55,42,11.46247389
2272,42057,Fulton County, Pennsylvania,44,14653,82,0,0,0,0,0,0,20,14,6,62,43,19,1624,49420,24327,"Fulton County, Pennsylvania",57,42,11.08305466
2273,42059,Greene County, Pennsylvania,42,37669,305,8,3,5,127,57,70,26,11,15,144,101,43,5141,49116,24389,"Greene County, Pennsylvania",59,42,13.64782713
2274,42061,Huntingdon County, Pennsylvania,42.7,45844,475,180,31,149,71,38,33,126,85,41,98,53,45,5572,45250,22217,"Huntingdon County, Pennsylvania",61,42,12.15426228
2275,42063,Indiana County, Pennsylvania,39,87491,1494,465,8,457,200,94,106,276,129,147,553,521,32,14533,45118,23886,"Indiana County, Pennsylvania",63,42,16.6108514
2276,42065,Jefferson County, Pennsylvania,43.8,44575,239,32,0,32,31,4,27,34,11,23,142,122,20,6364,43913,22841,"Jefferson County, Pennsylvania",65,42,14.27706113
2277,42067,Juniata County, Pennsylvania,43.2,24811,528,49,6,43,264,101,163,147,89,58,68,45,23,2926,49028,23461,"Juniata County, Pennsylvania",67,42,11.79315626
2278,42069,Lackawanna County, Pennsylvania,42.2,213006,10875,2947,239,2708,3897,1670,2227,1556,958,598,2475,1938,537,31288,46673,26179,"Lackawanna County, Pennsylvania",69,42,14.68878811
2279,42071,Lancaster County, Pennsylvania,38.5,533110,24378,4181,376,3805,7565,3383,4182,5148,3404,1744,7484,6076,1408,55977,59237,28152,"Lancaster County, Pennsylvania",71,42,10.50008441
2280,42073,Lawrence County, Pennsylvania,44.6,88528,1168,143,0,143,217,112,105,237,172,65,571,491,80,12374,45764,25614,"Lawrence County, Pennsylvania",73,42,13.97749864
2281,42075,Lebanon County, Pennsylvania,41.2,136950,5207,953,168,785,1706,697,1009,918,565,353,1630,1282,348,14293,56191,27051,"Lebanon County, Pennsylvania",75,42,10.43665571
2282,42077,Lehigh County, Pennsylvania,39.5,358792,37999,5107,635,4472,10806,4449,6357,8864,6032,2832,13222,11205,2017,45552,57685,29587,"Lehigh County, Pennsylvania",77,42,12.69593525
2283,42079,Luzerne County, Pennsylvania,43,318917,18109,3364,201,3163,5876,2586,3290,4498,2453,2045,4371,3114,1257,48174,46577,25899,"Luzerne County, Pennsylvania",79,42,15.10549767
2284,42081,Lycoming County, Pennsylvania,41.2,116313,1844,391,42,349,487,160,327,317,258,59,649,554,95,15932,48731,24855,"Lycoming County, Pennsylvania",81,42,13.69752306
2285,42083,McKean County, Pennsylvania,42.5,42609,672,64,0,64,97,25,72,228,171,57,283,152,131,6705,44023,24303,"McKean County, Pennsylvania",83,42,15.73611209
2286,42085,Mercer County, Pennsylvania,44.1,114598,1593,217,65,152,482,251,231,222,115,107,672,472,200,14962,45831,24399,"Mercer County, Pennsylvania",85,42,13.05607428
2287,42087,Mifflin County, Pennsylvania,43.5,46585,477,51,12,39,142,52,90,62,31,31,222,177,45,6676,42019,21665,"Mifflin County, Pennsylvania",87,42,14.33079317
2288,42089,Monroe County, Pennsylvania,42,167126,17928,1537,357,1180,3744,2048,1696,4504,3316,1188,8143,6593,1550,20071,58980,26128,"Monroe County, Pennsylvania",89,42,12.00950181
2289,42091,Montgomery County, Pennsylvania,41.2,815876,84438,12657,813,11844,24473,7704,16769,18155,13093,5062,29153,25630,3523,52250,81902,42995,"Montgomery County, Pennsylvania",91,42,6.404159456
2290,42093,Montour County, Pennsylvania,43.2,18404,596,77,8,69,220,54,166,99,75,24,200,156,44,1763,55233,31293,"Montour County, Pennsylvania",93,42,9.579439252
2291,42095,Northampton County, Pennsylvania,41.9,300520,21809,2891,223,2668,5410,2114,3296,4600,3313,1287,8908,7540,1368,26379,62753,31086,"Northampton County, Pennsylvania",95,42,8.777785172
2292,42097,Northumberland County, Pennsylvania,44.2,93590,1251,19,0,19,368,137,231,224,161,63,640,512,128,12974,43701,23512,"Northumberland County, Pennsylvania",97,42,13.86259216
2293,42099,Perry County, Pennsylvania,42.5,45647,592,70,0,70,190,69,121,87,27,60,245,152,93,3921,58585,27648,"Perry County, Pennsylvania",99,42,8.589830657
2294,42101,Philadelphia County, Pennsylvania,33.9,1559938,203909,39045,2866,36179,67399,26281,41118,47476,31834,15642,49989,39857,10132,392356,39770,23696,"Philadelphia County, Pennsylvania",101,42,25.15202527
2295,42103,Pike County, Pennsylvania,46.7,56210,4671,319,10,309,908,419,489,1146,750,396,2298,1835,463,5672,61199,29695,"Pike County, Pennsylvania",103,42,10.09073119
2296,42105,Potter County, Pennsylvania,46.3,17239,196,22,0,22,55,7,48,17,14,3,102,81,21,2395,40921,22929,"Potter County, Pennsylvania",105,42,13.89291722
2297,42107,Schuylkill County, Pennsylvania,44.1,145503,2688,194,10,184,556,158,398,741,220,521,1197,853,344,18029,46573,24275,"Schuylkill County, Pennsylvania",107,42,12.39080981
2298,42109,Snyder County, Pennsylvania,39.5,40246,548,49,9,40,210,124,86,146,82,64,143,54,89,4230,51110,24708,"Snyder County, Pennsylvania",109,42,10.51036128
2299,42111,Somerset County, Pennsylvania,45.5,76201,670,155,4,151,116,23,93,79,30,49,320,253,67,8993,45424,23402,"Somerset County, Pennsylvania",111,42,11.80168239
2300,42113,Sullivan County, Pennsylvania,52.4,6302,118,30,0,30,30,0,30,18,5,13,40,37,3,731,44926,26154,"Sullivan County, Pennsylvania",113,42,11.59949222
2301,42115,Susquehanna County, Pennsylvania,46.9,41832,674,29,10,19,184,25,159,65,31,34,396,316,80,5320,50160,26551,"Susquehanna County, Pennsylvania",115,42,12.71753681
2302,42117,Tioga County, Pennsylvania,43.2,42031,493,46,11,35,113,43,70,67,38,29,267,198,69,5509,48449,24626,"Tioga County, Pennsylvania",117,42,13.10699246
2303,42119,Union County, Pennsylvania,39.1,45178,1456,247,41,206,260,101,159,211,61,150,738,286,452,3991,51349,23316,"Union County, Pennsylvania",119,42,8.833945726
2304,42121,Venango County, Pennsylvania,45.8,53460,399,17,2,15,115,65,50,105,63,42,162,110,52,7535,43885,24257,"Venango County, Pennsylvania",121,42,14.09465021
2305,42123,Warren County, Pennsylvania,46.4,40649,480,55,4,51,167,50,117,46,32,14,212,203,9,5042,44977,25414,"Warren County, Pennsylvania",123,42,12.40374917
2306,42125,Washington County, Pennsylvania,44.3,208269,4161,618,12,606,1255,485,770,882,605,277,1406,1047,359,20471,57534,31561,"Washington County, Pennsylvania",125,42,9.829115231
2307,42127,Wayne County, Pennsylvania,47,51307,1502,54,9,45,162,75,87,336,205,131,950,740,210,6034,50595,24962,"Wayne County, Pennsylvania",127,42,11.76057848
2308,42129,Westmoreland County, Pennsylvania,46.3,359377,5548,718,98,620,1006,465,541,1479,1035,444,2345,2128,217,36398,54142,30153,"Westmoreland County, Pennsylvania",129,42,10.12808277
2309,42131,Wyoming County, Pennsylvania,43.7,27975,357,22,12,10,87,40,47,107,76,31,141,117,24,2817,53397,26823,"Wyoming County, Pennsylvania",131,42,10.06970509
2310,42133,York County, Pennsylvania,40.8,440604,15858,2037,257,1780,5339,2043,3296,3678,2124,1554,4804,4020,784,45113,59853,28975,"York County, Pennsylvania",133,42,10.23889933
2311,44001,Bristol County, Rhode Island,44.1,49228,4625,522,19,503,591,292,299,615,407,208,2897,2393,504,3246,73096,40998,"Bristol County, Rhode Island",1,44,6.593808402
2312,44003,Kent County, Rhode Island,43.7,164886,10044,665,35,630,1658,1014,644,2435,1635,800,5286,4413,873,13400,65592,35323,"Kent County, Rhode Island",3,44,8.12682702
2313,44005,Newport County, Rhode Island,44.2,82714,6038,974,17,957,1427,570,857,1002,490,512,2635,2229,406,7292,71347,42086,"Newport County, Rhode Island",5,44,8.815919917
2314,44007,Providence County, Rhode Island,37.3,631344,116490,17214,1538,15676,31308,10044,21264,25767,14202,11565,42201,31911,10290,104178,50637,27809,"Providence County, Rhode Island",7,44,16.50098837
2315,44009,Washington County, Rhode Island,43.9,126319,5466,710,63,647,1099,653,446,1023,784,239,2634,2027,607,12045,74302,37692,"Washington County, Rhode Island",9,44,9.535382642
2316,45001,Abbeville County, South Carolina,43.6,24951,246,23,0,23,170,31,139,33,29,4,20,15,5,5230,34652,18460,"Abbeville County, South Carolina",1,45,20.96108372
2317,45003,Aiken County, South Carolina,40.8,165146,7056,1033,61,972,2783,280,2503,1371,483,888,1869,1376,493,28253,46454,25602,"Aiken County, South Carolina",3,45,17.10789241
2318,45005,Allendale County, South Carolina,39.3,9589,110,17,0,17,17,0,17,51,36,15,25,5,20,2519,24817,12649,"Allendale County, South Carolina",5,45,26.26968401
2319,45007,Anderson County, South Carolina,40.5,192709,5202,950,58,892,1977,513,1464,978,411,567,1297,958,339,30879,43518,23341,"Anderson County, South Carolina",7,45,16.02364186
2320,45009,Bamberg County, South Carolina,41,15057,214,27,0,27,97,6,91,14,9,5,76,76,0,3806,32321,18260,"Bamberg County, South Carolina",9,45,25.27727967
2321,45011,Barnwell County, South Carolina,40.4,21917,289,28,20,8,113,15,98,38,4,34,110,110,0,5680,34787,19652,"Barnwell County, South Carolina",11,45,25.91595565
2322,45013,Beaufort County, South Carolina,43.6,175316,15794,1612,79,1533,6481,1199,5282,3851,1360,2491,3850,2848,1002,21115,59227,33877,"Beaufort County, South Carolina",13,45,12.04396632
2323,45015,Berkeley County, South Carolina,35.6,199081,10344,1568,103,1465,3001,859,2142,2486,1087,1399,3289,2816,473,25772,54484,25992,"Berkeley County, South Carolina",15,45,12.9454845
2324,45017,Calhoun County, South Carolina,45.8,14886,447,53,0,53,64,0,64,170,4,166,160,160,0,2834,42779,22964,"Calhoun County, South Carolina",17,45,19.0380223
2325,45019,Charleston County, South Carolina,36.8,380673,18528,2434,157,2277,7680,1623,6057,3456,1937,1519,4958,4056,902,60063,54931,33700,"Charleston County, South Carolina",19,45,15.77810877
2326,45021,Cherokee County, South Carolina,39.1,56274,1219,21,11,10,513,166,347,474,261,213,211,145,66,12593,35719,19940,"Cherokee County, South Carolina",21,45,22.37800761
2327,45023,Chester County, South Carolina,41.3,32435,208,0,0,0,24,0,24,3,0,3,181,157,24,7554,34319,19858,"Chester County, South Carolina",23,45,23.28965624
2328,45025,Chesterfield County, South Carolina,41.5,46083,1405,155,0,155,701,164,537,384,112,272,165,117,48,11158,35733,19088,"Chesterfield County, South Carolina",25,45,24.21283337
2329,45027,Clarendon County, South Carolina,43.1,34056,503,38,14,24,174,0,174,153,24,129,138,93,45,8400,34106,18765,"Clarendon County, South Carolina",27,45,24.66525722
2330,45029,Colleton County, South Carolina,42.2,37884,750,0,0,0,543,0,543,117,3,114,90,66,24,7733,33918,20297,"Colleton County, South Carolina",29,45,20.41231127
2331,45031,Darlington County, South Carolina,41.2,67689,1215,125,0,125,378,95,283,390,130,260,322,142,180,15241,34773,20144,"Darlington County, South Carolina",31,45,22.51621386
2332,45033,Dillon County, South Carolina,37.5,31273,918,4,2,2,629,264,365,216,48,168,69,55,14,9431,30955,15729,"Dillon County, South Carolina",33,45,30.15700444
2333,45035,Dorchester County, South Carolina,36,148517,7009,611,78,533,2102,808,1294,1848,1208,640,2448,1921,527,17625,56345,26288,"Dorchester County, South Carolina",35,45,11.86732832
2334,45037,Edgefield County, South Carolina,42.3,26388,1084,107,0,107,423,30,393,254,36,218,300,143,157,4002,48114,22695,"Edgefield County, South Carolina",37,45,15.16598454
2335,45039,Fairfield County, South Carolina,44.8,23025,438,120,0,120,89,0,89,101,26,75,128,122,6,5563,33798,20762,"Fairfield County, South Carolina",39,45,24.1606949
2336,45041,Florence County, South Carolina,38.5,138575,3702,256,23,233,1554,510,1044,747,433,314,1145,835,310,26515,42523,23420,"Florence County, South Carolina",41,45,19.13404294
2337,45043,Georgetown County, South Carolina,47.9,60804,1388,102,13,89,486,185,301,300,83,217,500,345,155,11514,45299,26601,"Georgetown County, South Carolina",43,45,18.93625419
2338,45045,Greenville County, South Carolina,37.9,482191,37834,6498,364,6134,14162,3485,10677,8652,3923,4729,8522,6511,2011,67067,51595,28065,"Greenville County, South Carolina",45,45,13.90880377
2339,45047,Greenwood County, South Carolina,39.1,69881,2822,585,49,536,961,117,844,663,96,567,613,315,298,16282,37631,21887,"Greenwood County, South Carolina",47,45,23.29960934
2340,45049,Hampton County, South Carolina,40.1,20296,377,17,0,17,154,77,77,120,47,73,86,21,65,3282,31734,20291,"Hampton County, South Carolina",49,45,16.17067402
2341,45051,Horry County, South Carolina,43.8,300418,18888,2121,144,1977,7534,1130,6404,3810,1845,1965,5423,4160,1263,52197,44746,24986,"Horry County, South Carolina",51,45,17.37479112
2342,45053,Jasper County, South Carolina,37.9,27186,2367,167,0,167,1436,26,1410,450,138,312,314,262,52,6256,38991,18921,"Jasper County, South Carolina",53,45,23.01184433
2343,45055,Kershaw County, South Carolina,41.8,63090,1162,46,29,17,264,50,214,301,112,189,551,437,114,9963,46328,23149,"Kershaw County, South Carolina",55,45,15.79172611
2344,45057,Lancaster County, South Carolina,41.5,83704,3085,363,7,356,971,242,729,569,197,372,1182,825,357,14201,46852,24528,"Lancaster County, South Carolina",57,45,16.9657364
2345,45059,Laurens County, South Carolina,40.8,66442,1761,262,10,252,728,129,599,485,106,379,286,140,146,13028,39848,20417,"Laurens County, South Carolina",59,45,19.60807923
2346,45061,Lee County, South Carolina,40.8,18189,92,0,0,0,11,0,11,24,24,0,57,28,29,4666,31169,15545,"Lee County, South Carolina",61,45,25.65286712
2347,45063,Lexington County, South Carolina,38.8,277702,13714,2249,128,2121,5001,837,4164,3298,1418,1880,3166,2530,636,37445,55412,28141,"Lexington County, South Carolina",63,45,13.4838784
2348,45065,McCormick County, South Carolina,52.4,9806,149,0,0,0,12,3,9,12,3,9,125,125,0,1672,41029,22454,"McCormick County, South Carolina",65,45,17.05078523
2349,45067,Marion County, South Carolina,40.2,31975,720,238,0,238,254,73,181,75,26,49,153,91,62,8225,30562,18373,"Marion County, South Carolina",67,45,25.72322127
2350,45069,Marlboro County, South Carolina,39.4,27702,705,32,8,24,158,16,142,301,64,237,214,82,132,6551,32601,15849,"Marlboro County, South Carolina",69,45,23.64811205
2351,45071,Newberry County, South Carolina,41.3,37750,1724,83,0,83,730,56,674,701,79,622,210,197,13,6828,39841,21883,"Newberry County, South Carolina",71,45,18.08741722
2352,45073,Oconee County, South Carolina,44.9,75375,2823,490,3,487,790,162,628,504,155,349,1039,868,171,13806,41818,25944,"Oconee County, South Carolina",73,45,18.31641791
2353,45075,Orangeburg County, South Carolina,39.1,89731,2015,221,0,221,668,86,582,463,177,286,663,540,123,20319,34763,18490,"Orangeburg County, South Carolina",75,45,22.64434811
2354,45077,Pickens County, South Carolina,35.8,120722,4599,1289,46,1243,1528,362,1166,772,201,571,1010,747,263,21236,43531,22258,"Pickens County, South Carolina",77,45,17.59082852
2355,45079,Richland County, South Carolina,32.9,401743,21170,4659,193,4466,6324,1673,4651,4599,3042,1557,5588,4543,1045,61606,50899,26852,"Richland County, South Carolina",79,45,15.33467914
2356,45081,Saluda County, South Carolina,41.2,20113,1823,199,0,199,723,49,674,718,129,589,183,49,134,3764,41458,21468,"Saluda County, South Carolina",81,45,18.71426441
2357,45083,Spartanburg County, South Carolina,38.2,294229,18688,1421,122,1299,5684,1350,4334,6015,3084,2931,5568,3582,1986,48747,45219,23277,"Spartanburg County, South Carolina",83,45,16.56770747
2358,45085,Sumter County, South Carolina,35.8,107682,3688,642,77,565,1186,308,878,626,106,520,1234,999,235,21063,40777,20916,"Sumter County, South Carolina",85,45,19.56037221
2359,45087,Union County, South Carolina,43.7,27928,130,0,0,0,28,9,19,41,24,17,61,19,42,5464,34953,19614,"Union County, South Carolina",87,45,19.56459467
2360,45089,Williamsburg County, South Carolina,41.5,32816,544,129,0,129,61,27,34,162,78,84,192,121,71,9056,28494,16650,"Williamsburg County, South Carolina",89,45,27.59629449
2361,45091,York County, South Carolina,38.2,245606,11767,1510,137,1373,3198,760,2438,3616,1961,1655,3443,2598,845,30218,56482,28830,"York County, South Carolina",91,45,12.30344536
2362,46003,Aurora County, South Dakota,41.4,2732,119,25,3,22,68,3,65,15,15,0,11,1,10,161,52620,28385,"Aurora County, South Dakota",3,46,5.893118594
2363,46005,Beadle County, South Dakota,38.3,18155,1971,615,49,566,1215,78,1137,108,37,71,33,16,17,3812,48423,24532,"Beadle County, South Dakota",5,46,20.99697053
2364,46007,Bennett County, South Dakota,29.4,3445,9,0,0,0,2,0,2,0,0,0,7,2,5,1286,45820,15011,"Bennett County, South Dakota",7,46,37.32946299
2365,46009,Bon Homme County, South Dakota,43.7,7001,139,23,12,11,6,0,6,13,1,12,97,70,27,601,48023,23359,"Bon Homme County, South Dakota",9,46,8.58448793
2366,46011,Brookings County, South Dakota,26.3,33435,1936,701,6,695,883,113,770,151,126,25,201,170,31,4949,52086,26589,"Brookings County, South Dakota",11,46,14.80185434
2367,46013,Brown County, South Dakota,37.7,38430,1437,443,50,393,747,122,625,94,76,18,153,132,21,4076,53073,29463,"Brown County, South Dakota",13,46,10.60629716
2368,46015,Brule County, South Dakota,40,5312,33,0,0,0,0,0,0,4,0,4,29,8,21,772,50696,24496,"Brule County, South Dakota",15,46,14.53313253
2369,46017,Buffalo County, South Dakota,25.1,2052,0,0,0,0,0,0,0,0,0,0,0,0,0,800,31293,10763,"Buffalo County, South Dakota",17,46,38.98635478
2370,46019,Butte County, South Dakota,40.6,10268,65,2,0,2,33,0,33,23,9,14,7,7,0,1028,43750,26067,"Butte County, South Dakota",19,46,10.01168679
2371,46021,Campbell County, South Dakota,49.8,1553,12,8,0,8,0,0,0,3,3,0,1,1,0,117,45800,32814,"Campbell County, South Dakota",21,46,7.533805538
2372,46023,Charles Mix County, South Dakota,36.3,9277,37,2,0,2,17,13,4,7,7,0,11,11,0,1927,43376,21323,"Charles Mix County, South Dakota",23,46,20.77180123
2373,46025,Clark County, South Dakota,42.4,3639,97,24,0,24,66,2,64,5,5,0,2,0,2,553,48563,26291,"Clark County, South Dakota",25,46,15.19648255
2374,46027,Clay County, South Dakota,24.9,14029,483,190,0,190,136,5,131,61,61,0,96,76,20,3223,38399,23046,"Clay County, South Dakota",27,46,22.9738399
2375,46029,Codington County, South Dakota,38.1,27886,367,98,32,66,95,67,28,103,102,1,71,54,17,2847,50133,27294,"Codington County, South Dakota",29,46,10.20942408
2376,46031,Corson County, South Dakota,29.7,4170,16,10,0,10,2,2,0,0,0,0,4,2,2,1929,32115,13830,"Corson County, South Dakota",31,46,46.25899281
2377,46033,Custer County, South Dakota,53.2,8447,192,11,3,8,50,0,50,90,66,24,41,41,0,944,52891,31275,"Custer County, South Dakota",33,46,11.17556529
2378,46035,Davison County, South Dakota,38.1,19824,340,6,0,6,123,0,123,26,12,14,185,131,54,2283,48310,26416,"Davison County, South Dakota",35,46,11.51634383
2379,46037,Day County, South Dakota,48.5,5588,42,26,0,26,2,0,2,9,0,9,5,5,0,997,40647,28811,"Day County, South Dakota",37,46,17.84180387
2380,46039,Deuel County, South Dakota,44.5,4309,16,11,0,11,1,0,1,0,0,0,4,0,4,448,54781,29953,"Deuel County, South Dakota",39,46,10.39684382
2381,46041,Dewey County, South Dakota,28.5,5652,14,3,0,3,8,8,0,3,0,3,0,0,0,1545,40585,16305,"Dewey County, South Dakota",41,46,27.33545648
2382,46043,Douglas County, South Dakota,48.4,2961,25,19,0,19,2,0,2,2,2,0,2,2,0,208,51290,27397,"Douglas County, South Dakota",43,46,7.024653833
2383,46045,Edmunds County, South Dakota,44.5,4000,41,19,9,10,14,6,8,7,0,7,1,1,0,380,62467,30123,"Edmunds County, South Dakota",45,46,9.5
2384,46047,Fall River County, South Dakota,52.6,6874,136,22,0,22,69,36,33,32,24,8,13,6,7,1115,45750,25591,"Fall River County, South Dakota",47,46,16.22054117
2385,46049,Faulk County, South Dakota,50,2354,4,2,0,2,2,2,0,0,0,0,0,0,0,287,43529,28975,"Faulk County, South Dakota",49,46,12.19201359
2386,46051,Grant County, South Dakota,44,7195,278,2,0,2,238,0,238,29,0,29,9,9,0,555,54180,28059,"Grant County, South Dakota",51,46,7.713690063
2387,46053,Gregory County, South Dakota,46.3,4217,30,0,0,0,5,0,5,13,13,0,12,12,0,686,40045,24738,"Gregory County, South Dakota",53,46,16.26748874
2388,46055,Haakon County, South Dakota,46.5,2073,0,0,0,0,0,0,0,0,0,0,0,0,0,365,39554,22643,"Haakon County, South Dakota",55,46,17.60733237
2389,46057,Hamlin County, South Dakota,36.3,5995,163,26,2,24,72,23,49,10,3,7,55,32,23,449,60169,26140,"Hamlin County, South Dakota",57,46,7.489574646
2390,46059,Hand County, South Dakota,48.2,3311,7,0,0,0,0,0,0,0,0,0,7,7,0,197,52266,33496,"Hand County, South Dakota",59,46,5.949864089
2391,46061,Hanson County, South Dakota,35.5,3390,2,0,0,0,1,1,0,0,0,0,1,1,0,339,60089,24159,"Hanson County, South Dakota",61,46,10
2392,46063,Harding County, South Dakota,42.9,1277,11,4,0,4,0,0,0,3,0,3,4,4,0,165,51458,27239,"Harding County, South Dakota",63,46,12.92090838
2393,46065,Hughes County, South Dakota,38.5,17518,215,0,0,0,100,0,100,65,45,20,50,18,32,1451,58934,30863,"Hughes County, South Dakota",65,46,8.282909008
2394,46067,Hutchinson County, South Dakota,44.6,7264,78,37,0,37,13,3,10,11,0,11,17,2,15,940,47356,28594,"Hutchinson County, South Dakota",67,46,12.94052863
2395,46069,Hyde County, South Dakota,48.3,1440,12,3,0,3,9,9,0,0,0,0,0,0,0,154,55000,28343,"Hyde County, South Dakota",69,46,10.69444444
2396,46071,Jackson County, South Dakota,30,3268,65,3,0,3,47,0,47,1,1,0,14,14,0,1167,41510,17601,"Jackson County, South Dakota",71,46,35.70991432
2397,46073,Jerauld County, South Dakota,47.2,2029,59,20,0,20,0,0,0,35,14,21,4,4,0,195,51442,36494,"Jerauld County, South Dakota",73,46,9.610645638
2398,46075,Jones County, South Dakota,53.1,767,2,0,0,0,0,0,0,0,0,0,2,0,2,79,39276,25229,"Jones County, South Dakota",75,46,10.29986962
2399,46077,Kingsbury County, South Dakota,46.5,5070,109,0,0,0,46,3,43,25,25,0,38,38,0,465,54568,31524,"Kingsbury County, South Dakota",77,46,9.171597633
2400,46079,Lake County, South Dakota,42.2,12331,92,21,0,21,54,24,30,4,4,0,13,0,13,1601,57239,29526,"Lake County, South Dakota",79,46,12.98353743
2401,46081,Lawrence County, South Dakota,41.4,24859,726,242,44,198,158,81,77,94,33,61,232,192,40,2873,48220,27002,"Lawrence County, South Dakota",81,46,11.55718251
2402,46083,Lincoln County, South Dakota,34.2,51396,1132,53,0,53,529,250,279,330,252,78,220,220,0,1903,77455,36896,"Lincoln County, South Dakota",83,46,3.702622772
2403,46085,Lyman County, South Dakota,35.4,3855,42,0,0,0,15,15,0,25,25,0,2,2,0,829,45921,20695,"Lyman County, South Dakota",85,46,21.50453956
2404,46087,McCook County, South Dakota,42.4,5616,100,25,0,25,44,5,39,3,1,2,28,22,6,566,58485,28424,"McCook County, South Dakota",87,46,10.07834758
2405,46089,McPherson County, South Dakota,52.3,2252,21,0,0,0,3,3,0,7,7,0,11,11,0,404,41338,25302,"McPherson County, South Dakota",89,46,17.93960924
2406,46091,Marshall County, South Dakota,41.8,4743,225,98,0,98,88,9,79,14,5,9,25,25,0,493,55398,27441,"Marshall County, South Dakota",91,46,10.39426523
2407,46093,Meade County, South Dakota,36.2,26840,442,101,0,101,161,101,60,60,60,0,120,84,36,2353,53069,25884,"Meade County, South Dakota",93,46,8.766766021
2408,46095,Mellette County, South Dakota,33,2083,11,5,0,5,0,0,0,0,0,0,6,6,0,937,29471,13934,"Mellette County, South Dakota",95,46,44.98319731
2409,46097,Miner County, South Dakota,41.1,2299,44,6,0,6,15,0,15,18,8,10,5,5,0,223,48542,28242,"Miner County, South Dakota",97,46,9.699869508
2410,46099,Minnehaha County, South Dakota,34.8,182014,11592,3501,292,3209,4564,1767,2797,1985,1055,930,1542,1110,432,20543,55293,28337,"Minnehaha County, South Dakota",99,46,11.28649445
2411,46101,Moody County, South Dakota,40,6445,252,179,0,179,26,10,16,7,7,0,40,39,1,935,54383,27324,"Moody County, South Dakota",101,46,14.50737005
2412,46102,Oglala Lakota County, South Dakota,24.6,14263,32,0,0,0,12,0,12,0,0,0,20,20,0,7622,26330,9286,"Oglala Lakota County, South Dakota",102,46,53.43896796
2413,46103,Pennington County, South Dakota,37.5,107298,2300,485,50,435,618,271,347,383,255,128,814,595,219,14402,51084,27964,"Pennington County, South Dakota",103,46,13.42243099
2414,46105,Perkins County, South Dakota,47.6,3019,23,0,0,0,4,0,4,3,0,3,16,14,2,400,45855,28576,"Perkins County, South Dakota",105,46,13.24942034
2415,46107,Potter County, South Dakota,53.5,2306,13,3,0,3,8,0,8,0,0,0,2,2,0,235,47991,30294,"Potter County, South Dakota",107,46,10.19080659
2416,46109,Roberts County, South Dakota,38.6,10294,87,19,0,19,37,1,36,3,3,0,28,23,5,2064,50108,24426,"Roberts County, South Dakota",109,46,20.05051486
2417,46111,Sanborn County, South Dakota,47.7,2349,29,23,0,23,1,0,1,0,0,0,5,5,0,199,51167,31991,"Sanborn County, South Dakota",111,46,8.471690081
2418,46115,Spink County, South Dakota,44.2,6539,34,4,0,4,4,4,0,1,0,1,25,25,0,703,49859,29158,"Spink County, South Dakota",115,46,10.75087934
2419,46117,Stanley County, South Dakota,41.1,2964,33,0,0,0,0,0,0,0,0,0,33,33,0,211,60046,33470,"Stanley County, South Dakota",117,46,7.118758435
2420,46119,Sully County, South Dakota,42.8,1456,13,13,0,13,0,0,0,0,0,0,0,0,0,63,59800,40042,"Sully County, South Dakota",119,46,4.326923077
2421,46121,Todd County, South Dakota,24.3,10019,189,114,2,112,7,1,6,27,25,2,41,34,7,4582,30800,11821,"Todd County, South Dakota",121,46,45.7331071
2422,46123,Tripp County, South Dakota,46.5,5475,58,3,0,3,9,0,9,43,43,0,3,3,0,1147,41210,26270,"Tripp County, South Dakota",123,46,20.94977169
2423,46125,Turner County, South Dakota,43.9,8289,56,13,0,13,23,1,22,15,10,5,5,3,2,837,54707,27405,"Turner County, South Dakota",125,46,10.09771987
2424,46127,Union County, South Dakota,41.6,14842,387,100,6,94,96,6,90,71,48,23,120,111,9,943,63890,35565,"Union County, South Dakota",127,46,6.35359116
2425,46129,Walworth County, South Dakota,44.6,5538,225,150,0,150,44,11,33,0,0,0,31,31,0,576,46526,29199,"Walworth County, South Dakota",129,46,10.40086674
2426,46135,Yankton County, South Dakota,41.3,22649,445,107,6,101,119,50,69,76,49,27,143,139,4,3055,48723,28067,"Yankton County, South Dakota",135,46,13.48845424
2427,46137,Ziebach County, South Dakota,28.3,2818,30,5,5,0,18,6,12,0,0,0,7,7,0,1106,36552,14047,"Ziebach County, South Dakota",137,46,39.2476934
2428,47001,Anderson County, Tennessee,43.3,75545,2306,426,21,405,975,123,852,253,148,105,652,588,64,12747,44241,26072,"Anderson County, Tennessee",1,47,16.87338672
2429,47003,Bedford County, Tennessee,36.9,46331,3138,343,1,342,1157,113,1044,1142,45,1097,496,435,61,7423,43819,21949,"Bedford County, Tennessee",3,47,16.02167016
2430,47005,Benton County, Tennessee,46.6,16173,293,13,0,13,31,0,31,121,50,71,128,38,90,3614,33611,20504,"Benton County, Tennessee",5,47,22.34588512
2431,47007,Bledsoe County, Tennessee,43,14073,194,49,0,49,63,0,63,39,17,22,43,25,18,3050,38535,18962,"Bledsoe County, Tennessee",7,47,21.6727066
2432,47009,Blount County, Tennessee,43,126192,3800,578,75,503,1259,333,926,885,408,477,1078,726,352,16793,49532,26772,"Blount County, Tennessee",9,47,13.30749968
2433,47011,Bradley County, Tennessee,39.3,102860,5316,624,17,607,1764,447,1317,1770,542,1228,1158,893,265,18291,43721,24099,"Bradley County, Tennessee",11,47,17.78242271
2434,47013,Campbell County, Tennessee,43.5,40008,160,12,0,12,17,0,17,22,10,12,109,100,9,8821,33628,19948,"Campbell County, Tennessee",13,47,22.04809038
2435,47015,Cannon County, Tennessee,42.1,13855,328,110,0,110,73,10,63,67,44,23,78,68,10,2208,43654,22571,"Cannon County, Tennessee",15,47,15.93648502
2436,47017,Carroll County, Tennessee,42.9,28417,418,49,7,42,119,6,113,142,91,51,108,47,61,5441,36212,19851,"Carroll County, Tennessee",17,47,19.14698948
2437,47019,Carter County, Tennessee,44,56707,540,20,0,20,220,63,157,102,66,36,198,152,46,13110,33177,20118,"Carter County, Tennessee",19,47,23.11883894
2438,47021,Cheatham County, Tennessee,40.2,39575,743,50,3,47,280,91,189,173,121,52,240,185,55,5061,53179,24279,"Cheatham County, Tennessee",21,47,12.7883765
2439,47023,Chester County, Tennessee,37.1,17355,530,98,0,98,189,30,159,190,145,45,53,43,10,2911,42376,19987,"Chester County, Tennessee",23,47,16.77326419
2440,47025,Claiborne County, Tennessee,42.3,31701,369,86,0,86,111,42,69,67,25,42,105,71,34,6771,33428,19215,"Claiborne County, Tennessee",25,47,21.35894767
2441,47027,Clay County, Tennessee,47.4,7769,152,53,0,53,39,0,39,0,0,0,60,42,18,1904,28147,16470,"Clay County, Tennessee",27,47,24.50765864
2442,47029,Cocke County, Tennessee,44.5,35256,319,26,0,26,73,0,73,109,47,62,111,108,3,9081,31081,18959,"Cocke County, Tennessee",29,47,25.7573179
2443,47031,Coffee County, Tennessee,40.1,53808,1444,54,0,54,649,56,593,379,63,316,362,254,108,8437,45456,23404,"Coffee County, Tennessee",31,47,15.67982456
2444,47033,Crockett County, Tennessee,39.6,14558,593,49,11,38,193,22,171,232,56,176,119,48,71,2602,38043,20542,"Crockett County, Tennessee",33,47,17.87333425
2445,47035,Cumberland County, Tennessee,50.1,57895,1434,267,22,245,340,25,315,192,75,117,635,520,115,9075,40123,22606,"Cumberland County, Tennessee",35,47,15.67492875
2446,47037,Davidson County, Tennessee,34.2,667885,81418,17347,714,16633,33194,8516,24678,19418,8977,10441,11459,8114,3345,114238,50484,30595,"Davidson County, Tennessee",37,47,17.10444163
2447,47039,Decatur County, Tennessee,45.5,11703,183,63,0,63,94,12,82,20,19,1,6,6,0,2399,38180,21977,"Decatur County, Tennessee",39,47,20.49901735
2448,47041,DeKalb County, Tennessee,40.9,19159,1129,418,0,418,504,193,311,62,33,29,145,89,56,4152,37640,25273,"DeKalb County, Tennessee",41,47,21.67127721
2449,47043,Dickson County, Tennessee,40,50926,1015,66,5,61,366,56,310,383,200,183,200,95,105,8019,47137,23426,"Dickson County, Tennessee",43,47,15.7463771
2450,47045,Dyer County, Tennessee,40.3,37970,840,94,8,86,359,135,224,154,18,136,233,192,41,6915,42833,23936,"Dyer County, Tennessee",45,47,18.21174612
2451,47047,Fayette County, Tennessee,44.4,39071,845,157,42,115,290,166,124,200,159,41,198,166,32,5774,55972,29018,"Fayette County, Tennessee",47,47,14.77822426
2452,47049,Fentress County, Tennessee,44.3,17936,183,16,0,16,27,0,27,59,45,14,81,81,0,4107,31714,17487,"Fentress County, Tennessee",49,47,22.89808207
2453,47051,Franklin County, Tennessee,41.9,41348,1078,316,0,316,292,153,139,146,89,57,324,276,48,6397,44837,23797,"Franklin County, Tennessee",51,47,15.47112315
2454,47053,Gibson County, Tennessee,40.3,49511,513,31,4,27,180,77,103,171,62,109,131,95,36,9039,38854,20948,"Gibson County, Tennessee",53,47,18.25654905
2455,47055,Giles County, Tennessee,42.9,29034,722,272,0,272,262,50,212,64,11,53,124,42,82,4721,40635,21487,"Giles County, Tennessee",55,47,16.26024661
2456,47057,Grainger County, Tennessee,44.2,22813,465,60,0,60,64,39,25,221,41,180,120,71,49,4578,37522,19850,"Grainger County, Tennessee",57,47,20.06750537
2457,47059,Greene County, Tennessee,44,68502,908,132,0,132,271,50,221,163,63,100,342,145,197,12373,36711,21525,"Greene County, Tennessee",59,47,18.06224636
2458,47061,Grundy County, Tennessee,43,13494,93,7,0,7,15,0,15,26,0,26,45,42,3,3718,28467,16132,"Grundy County, Tennessee",61,47,27.55298651
2459,47063,Hamblen County, Tennessee,40.5,63203,3863,363,0,363,1970,100,1870,940,64,876,590,443,147,13112,39270,20642,"Hamblen County, Tennessee",63,47,20.74585067
2460,47065,Hamilton County, Tennessee,39.3,351305,17341,2555,297,2258,7249,1814,5435,3495,2076,1419,4042,3107,935,50631,49434,28456,"Hamilton County, Tennessee",65,47,14.41226285
2461,47067,Hancock County, Tennessee,44.3,6609,68,6,6,0,31,0,31,22,0,22,9,9,0,1757,27973,16351,"Hancock County, Tennessee",67,47,26.5849599
2462,47069,Hardeman County, Tennessee,39.9,25975,375,0,0,0,57,12,45,100,25,75,218,189,29,5285,33566,16178,"Hardeman County, Tennessee",69,47,20.34648701
2463,47071,Hardin County, Tennessee,45.1,25839,359,104,104,0,159,9,150,52,6,46,44,41,3,5634,37244,22928,"Hardin County, Tennessee",71,47,21.80424939
2464,47073,Hawkins County, Tennessee,43.8,56567,565,28,0,28,180,51,129,121,43,78,236,153,83,10706,37883,21394,"Hawkins County, Tennessee",73,47,18.92622907
2465,47075,Haywood County, Tennessee,40.4,18129,305,17,0,17,151,22,129,56,38,18,81,25,56,3744,35094,19956,"Haywood County, Tennessee",75,47,20.65199404
2466,47077,Henderson County, Tennessee,40.4,27952,181,3,3,0,89,0,89,40,8,32,49,45,4,5703,41478,20479,"Henderson County, Tennessee",77,47,20.40283343
2467,47079,Henry County, Tennessee,45.1,32291,504,17,0,17,182,61,121,57,0,57,248,215,33,6151,38378,23090,"Henry County, Tennessee",79,47,19.04865133
2468,47081,Hickman County, Tennessee,40.4,24251,248,0,0,0,125,11,114,81,0,81,42,36,6,5181,37546,18410,"Hickman County, Tennessee",81,47,21.36406746
2469,47083,Houston County, Tennessee,43.5,8234,83,0,0,0,0,0,0,21,15,6,62,26,36,1672,40680,18256,"Houston County, Tennessee",83,47,20.30604809
2470,47085,Humphreys County, Tennessee,41.7,18216,94,0,0,0,10,10,0,12,0,12,72,59,13,3308,40995,23221,"Humphreys County, Tennessee",85,47,18.15985946
2471,47087,Jackson County, Tennessee,46.1,11526,34,0,0,0,12,0,12,6,6,0,16,12,4,2835,32676,17675,"Jackson County, Tennessee",87,47,24.59656429
2472,47089,Jefferson County, Tennessee,42.7,52851,1166,254,8,246,426,25,401,265,34,231,221,166,55,7724,43673,22674,"Jefferson County, Tennessee",89,47,14.61467143
2473,47091,Johnson County, Tennessee,44.8,17923,257,6,0,6,86,19,67,61,12,49,104,60,44,4313,30180,17834,"Johnson County, Tennessee",91,47,24.06405178
2474,47093,Knox County, Tennessee,37.3,448164,22060,3638,238,3400,8387,2310,6077,5296,3060,2236,4739,4061,678,70612,50366,28980,"Knox County, Tennessee",93,47,15.75583938
2475,47095,Lake County, Tennessee,40.7,7643,92,5,0,5,30,13,17,23,11,12,34,11,23,1413,29893,13330,"Lake County, Tennessee",95,47,18.48750491
2476,47097,Lauderdale County, Tennessee,37.6,27261,479,27,0,27,184,37,147,150,55,95,118,86,32,6014,32353,16217,"Lauderdale County, Tennessee",97,47,22.06081949
2477,47099,Lawrence County, Tennessee,39.9,42406,665,46,0,46,215,34,181,69,34,35,335,214,121,8136,40457,19802,"Lawrence County, Tennessee",99,47,19.18596425
2478,47101,Lewis County, Tennessee,43.6,11907,286,0,0,0,241,123,118,0,0,0,45,33,12,2384,36920,19877,"Lewis County, Tennessee",101,47,20.02183589
2479,47103,Lincoln County, Tennessee,42.9,33582,435,136,0,136,168,7,161,22,12,10,109,67,42,6123,41038,22541,"Lincoln County, Tennessee",103,47,18.23298195
2480,47105,Loudon County, Tennessee,47.2,50637,3625,346,23,323,1722,252,1470,689,144,545,868,584,284,6767,52995,28660,"Loudon County, Tennessee",105,47,13.36374588
2481,47107,McMinn County, Tennessee,42.9,52606,1324,273,26,247,382,31,351,273,49,224,396,243,153,10012,38661,20472,"McMinn County, Tennessee",107,47,19.03204958
2482,47109,McNairy County, Tennessee,42.9,26057,177,19,0,19,68,57,11,54,38,16,36,36,0,5916,31956,18285,"McNairy County, Tennessee",109,47,22.70407184
2483,47111,Macon County, Tennessee,39.6,22924,592,61,0,61,367,21,346,84,53,31,80,69,11,4167,34098,19437,"Macon County, Tennessee",111,47,18.17745594
2484,47113,Madison County, Tennessee,37.8,98128,2493,308,47,261,1004,316,688,489,248,241,692,531,161,18345,44237,23724,"Madison County, Tennessee",113,47,18.69496984
2485,47115,Marion County, Tennessee,43.2,28363,292,16,0,16,134,41,93,56,27,29,86,67,19,5374,41477,22056,"Marion County, Tennessee",115,47,18.94721997
2486,47117,Marshall County, Tennessee,39.6,31335,632,15,0,15,196,0,196,249,0,249,172,162,10,4655,44900,23407,"Marshall County, Tennessee",117,47,14.85559279
2487,47119,Maury County, Tennessee,39.1,85767,3478,520,44,476,1088,205,883,978,514,464,892,713,179,12413,49597,24986,"Maury County, Tennessee",119,47,14.47293248
2488,47121,Meigs County, Tennessee,43.9,11804,126,0,0,0,59,59,0,22,22,0,45,45,0,2160,35209,19976,"Meigs County, Tennessee",121,47,18.29888174
2489,47123,Monroe County, Tennessee,43.1,45482,1323,34,34,0,571,146,425,107,61,46,611,264,347,8575,37054,19840,"Monroe County, Tennessee",123,47,18.85361242
2490,47125,Montgomery County, Tennessee,30.3,189709,9447,1141,127,1014,3490,1386,2104,1913,1216,697,2903,2240,663,28232,51528,23384,"Montgomery County, Tennessee",125,47,14.88173993
2491,47127,Moore County, Tennessee,46.5,6314,27,0,0,0,0,0,0,7,7,0,20,20,0,644,49496,30126,"Moore County, Tennessee",127,47,10.19955654
2492,47129,Morgan County, Tennessee,41.1,21688,140,1,0,1,42,5,37,57,32,25,40,22,18,4415,39728,18281,"Morgan County, Tennessee",129,47,20.35687938
2493,47131,Obion County, Tennessee,42.5,30900,679,77,0,77,224,73,151,189,79,110,189,93,96,6399,38933,21650,"Obion County, Tennessee",131,47,20.70873786
2494,47133,Overton County, Tennessee,42.6,22090,257,6,0,6,68,68,0,45,0,45,138,103,35,4340,35065,19827,"Overton County, Tennessee",133,47,19.64689905
2495,47135,Perry County, Tennessee,43.3,7891,60,12,0,12,6,6,0,23,10,13,19,19,0,2216,31274,18611,"Perry County, Tennessee",135,47,28.08262578
2496,47137,Pickett County, Tennessee,49.8,5096,77,0,0,0,23,0,23,15,9,6,39,39,0,827,39014,20664,"Pickett County, Tennessee",137,47,16.22841444
2497,47139,Polk County, Tennessee,44.6,16697,140,20,0,20,62,0,62,3,0,3,55,23,32,2918,41520,22768,"Polk County, Tennessee",139,47,17.47619333
2498,47141,Putnam County, Tennessee,36.1,74652,4368,1359,53,1306,1455,186,1269,750,188,562,804,469,335,17180,36350,22555,"Putnam County, Tennessee",141,47,23.01344907
2499,47143,Rhea County, Tennessee,40.3,32461,768,203,31,172,315,0,315,106,37,69,144,139,5,7160,38355,20888,"Rhea County, Tennessee",143,47,22.05723792
2500,47145,Roane County, Tennessee,46.3,52983,1072,160,43,117,359,76,283,57,31,26,496,400,96,8449,42299,23942,"Roane County, Tennessee",145,47,15.94662439
2501,47147,Robertson County, Tennessee,38.5,67905,2391,504,0,504,998,108,890,515,159,356,374,200,174,7067,56331,25534,"Robertson County, Tennessee",147,47,10.40718651
2502,47149,Rutherford County, Tennessee,32.9,290289,20337,3492,253,3239,7206,2218,4988,4460,1966,2494,5179,3694,1485,35764,58032,26373,"Rutherford County, Tennessee",149,47,12.32013614
2503,47151,Scott County, Tennessee,38.8,22029,36,7,7,0,24,0,24,0,0,0,5,5,0,6000,30897,21011,"Scott County, Tennessee",151,47,27.23682419
2504,47153,Sequatchie County, Tennessee,42.5,14710,129,8,0,8,67,5,62,44,5,39,10,10,0,2328,46541,21605,"Sequatchie County, Tennessee",153,47,15.82596873
2505,47155,Sevier County, Tennessee,42.4,94537,4773,946,84,862,1715,138,1577,851,271,580,1261,941,320,14285,42586,22773,"Sevier County, Tennessee",155,47,15.11048584
2506,47157,Shelby County, Tennessee,35.1,936990,58040,9693,446,9247,23528,4792,18736,13425,5951,7474,11394,8798,2596,196471,46854,26963,"Shelby County, Tennessee",157,47,20.96831343
2507,47159,Smith County, Tennessee,41.2,19176,265,28,0,28,72,8,64,89,66,23,76,61,15,3050,44272,23108,"Smith County, Tennessee",159,47,15.90529829
2508,47161,Stewart County, Tennessee,43.4,13257,333,1,0,1,51,0,51,58,30,28,223,157,66,2520,41835,21652,"Stewart County, Tennessee",161,47,19.00882553
2509,47163,Sullivan County, Tennessee,44.5,156644,2471,332,0,332,758,352,406,566,330,236,815,641,174,25982,40983,24680,"Sullivan County, Tennessee",163,47,16.58665509
2510,47165,Sumner County, Tennessee,39.5,172786,6226,958,69,889,2111,571,1540,1423,738,685,1734,1427,307,16543,58972,29313,"Sumner County, Tennessee",165,47,9.574271064
2511,47167,Tipton County, Tennessee,37.3,61558,873,195,0,195,232,96,136,232,55,177,214,212,2,8378,54650,24969,"Tipton County, Tennessee",167,47,13.60992885
2512,47169,Trousdale County, Tennessee,39,7970,135,33,16,17,78,72,6,0,0,0,24,6,18,1043,47667,23319,"Trousdale County, Tennessee",169,47,13.08657465
2513,47171,Unicoi County, Tennessee,45.6,17945,499,48,0,48,315,12,303,52,12,40,84,23,61,3687,35390,20958,"Unicoi County, Tennessee",171,47,20.54611312
2514,47173,Union County, Tennessee,41.5,19081,139,31,0,31,50,10,40,1,0,1,57,18,39,4420,38540,19030,"Union County, Tennessee",173,47,23.16440438
2515,47175,Van Buren County, Tennessee,45.8,5641,97,0,0,0,24,0,24,35,2,33,38,38,0,1058,42813,21348,"Van Buren County, Tennessee",175,47,18.7555398
2516,47177,Warren County, Tennessee,39.9,40099,1882,323,4,319,700,53,647,594,146,448,265,208,57,8158,36245,20749,"Warren County, Tennessee",177,47,20.344647
2517,47179,Washington County, Tennessee,39.7,126044,4469,901,20,881,1602,396,1206,783,357,426,1183,964,219,20810,44444,26662,"Washington County, Tennessee",179,47,16.51010758
2518,47181,Wayne County, Tennessee,41.9,16842,208,5,0,5,87,7,80,67,44,23,49,44,5,2796,34008,17735,"Wayne County, Tennessee",181,47,16.60135376
2519,47183,Weakley County, Tennessee,37.5,34024,430,145,9,136,146,64,82,44,34,10,95,84,11,5962,38040,19847,"Weakley County, Tennessee",183,47,17.52292499
2520,47185,White County, Tennessee,43.5,26373,328,86,29,57,8,0,8,45,10,35,189,149,40,4662,35989,18785,"White County, Tennessee",185,47,17.67716983
2521,47187,Williamson County, Tennessee,39,205645,14039,2980,253,2727,4636,1789,2847,2652,1634,1018,3771,3369,402,10547,100140,46494,"Williamson County, Tennessee",187,47,5.128741277
2522,47189,Wilson County, Tennessee,40.3,125616,5193,863,105,758,1742,782,960,1197,535,662,1391,1099,292,11266,63426,29762,"Wilson County, Tennessee",189,47,8.968602726
2523,48001,Anderson County, Texas,38.9,57772,3776,382,45,337,1068,120,948,1065,316,749,1261,733,528,7561,42146,18087,"Anderson County, Texas",1,48,13.08765492
2524,48003,Andrews County, Texas,31.2,17215,2325,367,0,367,404,47,357,370,122,248,1184,617,567,1821,70121,29240,"Andrews County, Texas",3,48,10.57798432
2525,48005,Angelina County, Texas,36.7,87657,7049,538,75,463,1844,169,1675,2285,481,1804,2382,1418,964,16688,44185,21486,"Angelina County, Texas",5,48,19.03784067
2526,48007,Aransas County, Texas,50.7,24729,1361,72,0,72,268,111,157,275,77,198,746,558,188,4124,44851,29426,"Aransas County, Texas",7,48,16.67677625
2527,48009,Archer County, Texas,44.1,8750,291,3,0,3,56,17,39,134,30,104,98,36,62,704,62407,29086,"Archer County, Texas",9,48,8.045714286
2528,48011,Armstrong County, Texas,45.9,1913,41,0,0,0,11,0,11,0,0,0,30,21,9,177,65000,28542,"Armstrong County, Texas",11,48,9.252483011
2529,48013,Atascosa County, Texas,35.4,47710,2947,224,0,224,397,53,344,478,250,228,1848,916,932,7208,53181,23416,"Atascosa County, Texas",13,48,15.10794383
2530,48015,Austin County, Texas,40.8,29107,2895,395,0,395,835,7,828,865,245,620,800,482,318,4163,56681,28351,"Austin County, Texas",15,48,14.30240148
2531,48017,Bailey County, Texas,34.4,7131,1482,342,0,342,512,9,503,324,93,231,304,168,136,1322,40589,17710,"Bailey County, Texas",17,48,18.53877437
2532,48019,Bandera County, Texas,51.3,21015,735,89,0,89,85,14,71,131,63,68,430,348,82,3409,55434,28547,"Bandera County, Texas",19,48,16.22174637
2533,48021,Bastrop County, Texas,38.5,78286,8506,626,11,615,2937,263,2674,2903,387,2516,2040,847,1193,10350,55808,25242,"Bastrop County, Texas",21,48,13.22075467
2534,48023,Baylor County, Texas,48.6,3639,90,0,0,0,0,0,0,40,32,8,50,34,16,452,34382,30495,"Baylor County, Texas",23,48,12.42099478
2535,48025,Bee County, Texas,35.8,32706,1421,83,43,40,277,37,240,293,32,261,768,429,339,5121,44005,17504,"Bee County, Texas",25,48,15.65767749
2536,48027,Bell County, Texas,30.4,330859,26953,3537,428,3109,7328,2777,4551,6039,3067,2972,10049,7421,2628,47165,51529,24213,"Bell County, Texas",27,48,14.25531722
2537,48029,Bexar County, Texas,33.2,1858699,245276,30727,2146,28581,66196,13320,52876,54654,20639,34015,93699,60732,32967,313406,52353,25317,"Bexar County, Texas",29,48,16.86157899
2538,48031,Blanco County, Texas,48.7,10918,782,147,0,147,137,49,88,103,29,74,395,185,210,1045,56573,30982,"Blanco County, Texas",31,48,9.571350064
2539,48033,Borden County, Texas,33,698,12,0,0,0,0,0,0,12,12,0,0,0,0,18,77569,42236,"Borden County, Texas",33,48,2.578796562
2540,48035,Bosque County, Texas,46.3,17953,1169,32,2,30,315,46,269,377,74,303,445,259,186,2599,45419,24815,"Bosque County, Texas",35,48,14.47668913
2541,48037,Bowie County, Texas,37.8,93483,3883,717,210,507,1384,315,1069,901,341,560,881,608,273,17166,42683,23705,"Bowie County, Texas",37,48,18.36269696
2542,48039,Brazoria County, Texas,35.5,338419,45094,3680,675,3005,14263,5013,9250,11334,5591,5743,15817,10953,4864,34248,72006,31180,"Brazoria County, Texas",39,48,10.11999917
2543,48041,Brazos County, Texas,25.5,209896,27812,7450,167,7283,9898,1696,8202,5597,1891,3706,4867,2960,1907,52652,41654,24157,"Brazos County, Texas",41,48,25.0848039
2544,48043,Brewster County, Texas,42.5,9188,536,35,0,35,57,22,35,178,83,95,266,162,104,1023,38440,26156,"Brewster County, Texas",43,48,11.13408794
2545,48045,Briscoe County, Texas,43.2,1672,192,11,11,0,36,2,34,87,7,80,58,16,42,239,40385,22906,"Briscoe County, Texas",45,48,14.29425837
2546,48047,Brooks County, Texas,31.5,7217,573,226,0,226,130,21,109,25,9,16,192,51,141,2358,24913,14885,"Brooks County, Texas",47,48,32.67285576
2547,48049,Brown County, Texas,40.9,37935,2024,217,0,217,611,124,487,392,43,349,804,322,482,6390,43235,22090,"Brown County, Texas",49,48,16.84460261
2548,48051,Burleson County, Texas,43,17417,1224,185,0,185,282,40,242,358,73,285,399,224,175,2329,52513,25833,"Burleson County, Texas",51,48,13.37199288
2549,48053,Burnet County, Texas,43.9,44584,2204,0,0,0,516,85,431,271,115,156,1417,816,601,6346,54259,27434,"Burnet County, Texas",53,48,14.23380585
2550,48055,Caldwell County, Texas,35.6,39848,3274,308,17,291,1143,129,1014,665,208,457,1158,430,728,7014,49533,21485,"Caldwell County, Texas",55,48,17.60188717
2551,48057,Calhoun County, Texas,38.1,21805,2174,140,0,140,774,83,691,424,166,258,836,574,262,3914,54167,25181,"Calhoun County, Texas",57,48,17.95001147
2552,48059,Callahan County, Texas,43.5,13596,291,21,0,21,72,0,72,8,0,8,190,148,42,2424,40568,22557,"Callahan County, Texas",59,48,17.82877317
2553,48061,Cameron County, Texas,31.3,418785,100435,9234,317,8917,24640,3007,21633,23788,6042,17746,42773,22476,20297,136809,34578,15457,"Cameron County, Texas",61,48,32.6680755
2554,48063,Camp County, Texas,38.8,12631,1459,359,313,46,327,104,223,432,70,362,341,213,128,2422,40045,20034,"Camp County, Texas",63,48,19.17504552
2555,48065,Carson County, Texas,40.4,6027,123,7,0,7,41,0,41,23,6,17,52,41,11,351,64554,28943,"Carson County, Texas",65,48,5.823792932
2556,48067,Cass County, Texas,43,30346,578,80,26,54,182,110,72,117,53,64,199,122,77,5736,39366,21608,"Cass County, Texas",67,48,18.90199697
2557,48069,Castro County, Texas,34.7,7875,1562,240,69,171,371,54,317,315,94,221,636,231,405,1256,42733,21230,"Castro County, Texas",69,48,15.94920635
2558,48071,Chambers County, Texas,35.5,38072,3981,488,9,479,1581,186,1395,995,185,810,917,396,521,4411,70396,29729,"Chambers County, Texas",71,48,11.58594242
2559,48073,Cherokee County, Texas,37.7,51257,4595,484,51,433,1327,240,1087,1561,244,1317,1223,632,591,10570,40769,19871,"Cherokee County, Texas",73,48,20.62157364
2560,48075,Childress County, Texas,33.5,7059,389,44,0,44,143,32,111,52,41,11,150,120,30,1342,37125,18745,"Childress County, Texas",75,48,19.01119139
2561,48077,Clay County, Texas,45.9,10367,224,39,0,39,93,1,92,51,0,51,41,22,19,1575,45341,26696,"Clay County, Texas",77,48,15.19243754
2562,48079,Cochran County, Texas,33.8,2955,354,85,0,85,97,12,85,19,9,10,153,67,86,569,38625,20408,"Cochran County, Texas",79,48,19.25549915
2563,48081,Coke County, Texas,49.1,3228,113,3,0,3,22,18,4,15,15,0,73,35,38,534,41756,27755,"Coke County, Texas",81,48,16.54275093
2564,48083,Coleman County, Texas,47.2,8476,156,33,0,33,38,0,38,0,0,0,85,44,41,1545,42049,25178,"Coleman County, Texas",83,48,18.22793771
2565,48085,Collin County, Texas,36.2,886633,168441,26827,1335,25492,54068,16426,37642,45944,27855,18089,41602,35060,6542,62651,86188,39933,"Collin County, Texas",85,48,7.066170558
2566,48087,Collingsworth County, Texas,36.9,3032,398,1,0,1,118,0,118,136,5,131,143,24,119,582,40257,21116,"Collingsworth County, Texas",87,48,19.19525066
2567,48089,Colorado County, Texas,43.9,20792,1890,290,55,235,304,49,255,549,239,310,747,520,227,2854,45398,26161,"Colorado County, Texas",89,48,13.72643324
2568,48091,Comal County, Texas,42.5,124234,7994,1268,95,1173,2031,316,1715,1727,665,1062,2968,2031,937,11356,69666,33872,"Comal County, Texas",91,48,9.140814914
2569,48093,Comanche County, Texas,44.4,13506,942,106,0,106,405,5,400,173,77,96,258,140,118,2825,39054,21681,"Comanche County, Texas",93,48,20.91662965
2570,48095,Concho County, Texas,41.3,4142,1374,231,0,231,360,0,360,373,0,373,410,31,379,293,48516,16599,"Concho County, Texas",95,48,7.073877354
2571,48097,Cooke County, Texas,40.4,38878,3273,389,0,389,1175,152,1023,788,70,718,921,486,435,5726,56269,28045,"Cooke County, Texas",97,48,14.72812387
2572,48099,Coryell County, Texas,31,75710,4804,506,165,341,1290,480,810,1262,681,581,1746,1273,473,8697,49275,20555,"Coryell County, Texas",99,48,11.487254
2573,48101,Cottle County, Texas,48,1560,72,0,0,0,31,0,31,6,0,6,35,0,35,388,33750,20397,"Cottle County, Texas",101,48,24.87179487
2574,48103,Crane County, Texas,33.1,4823,854,99,8,91,165,26,139,73,51,22,517,229,288,550,60133,25367,"Crane County, Texas",103,48,11.40369065
2575,48105,Crockett County, Texas,40.5,3836,320,0,0,0,97,22,75,98,0,98,125,71,54,851,50646,23861,"Crockett County, Texas",105,48,22.18456726
2576,48107,Crosby County, Texas,38.7,5987,187,14,2,12,27,0,27,37,0,37,109,44,65,1177,39026,19651,"Crosby County, Texas",107,48,19.65926173
2577,48109,Culberson County, Texas,40.5,2259,317,8,0,8,35,5,30,36,0,36,238,150,88,535,33981,18862,"Culberson County, Texas",109,48,23.6830456
2578,48111,Dallam County, Texas,31,7052,1123,279,3,276,386,82,304,256,143,113,202,129,73,1129,43897,19908,"Dallam County, Texas",111,48,16.00964265
2579,48113,Dallas County, Texas,33.2,2513054,594258,77752,3858,73894,197038,32314,164724,171792,49966,121826,147676,86151,61525,461045,51411,28552,"Dallas County, Texas",113,48,18.3460045
2580,48115,Dawson County, Texas,33.1,13317,1004,73,0,73,322,78,244,163,11,152,446,187,259,1866,42354,21193,"Dawson County, Texas",115,48,14.0121649
2581,48117,Deaf Smith County, Texas,31.4,19039,3168,262,11,251,791,39,752,830,159,671,1285,453,832,3235,47219,19823,"Deaf Smith County, Texas",117,48,16.99143863
2582,48119,Delta County, Texas,43.8,5226,87,0,0,0,10,10,0,46,0,46,31,24,7,1110,40529,20822,"Delta County, Texas",119,48,21.23995408
2583,48121,Denton County, Texas,34.5,754650,108820,13682,1101,12581,35927,9796,26131,31696,15107,16589,27515,20639,6876,64613,76678,36238,"Denton County, Texas",121,48,8.561982376
2584,48123,DeWitt County, Texas,42,20660,704,34,4,30,96,23,73,181,20,161,393,176,217,3038,50582,27370,"DeWitt County, Texas",123,48,14.70474347
2585,48125,Dickens County, Texas,42.8,2237,103,16,0,16,9,0,9,48,6,42,30,4,26,391,42118,22526,"Dickens County, Texas",125,48,17.4787662
2586,48127,Dimmit County, Texas,34,10842,600,15,0,15,10,0,10,62,12,50,513,283,230,2504,32204,19528,"Dimmit County, Texas",127,48,23.09536986
2587,48129,Donley County, Texas,40.9,3506,76,11,0,11,31,5,26,17,2,15,17,17,0,481,40560,22454,"Donley County, Texas",129,48,13.71933828
2588,48131,Duval County, Texas,37.3,11510,511,0,0,0,73,0,73,243,130,113,195,139,56,2675,33115,19853,"Duval County, Texas",131,48,23.2406603
2589,48133,Eastland County, Texas,42.5,18252,688,38,0,38,123,0,123,138,16,122,389,208,181,3054,34434,21577,"Eastland County, Texas",133,48,16.73241289
2590,48135,Ector County, Texas,30.4,153177,20655,2284,111,2173,4651,718,3933,4542,1398,3144,9178,4711,4467,18777,58335,27295,"Ector County, Texas",135,48,12.25836777
2591,48137,Edwards County, Texas,49.2,2028,211,1,0,1,14,0,14,3,0,3,193,154,39,156,39457,27333,"Edwards County, Texas",137,48,7.692307692
2592,48139,Ellis County, Texas,35.9,160225,13569,1454,25,1429,3307,427,2880,4238,1125,3113,4570,2597,1973,17458,64382,27313,"Ellis County, Texas",139,48,10.8959276
2593,48141,El Paso County, Texas,31.6,833592,211424,22253,1369,20884,45923,10121,35802,44536,17303,27233,98712,61706,37006,183925,42075,19145,"El Paso County, Texas",141,48,22.06415129
2594,48143,Erath County, Texas,30.2,40641,3183,121,13,108,965,290,675,863,325,538,1234,594,640,9500,42492,22781,"Erath County, Texas",143,48,23.37540907
2595,48145,Falls County, Texas,39.3,17265,986,133,13,120,165,51,114,286,108,178,402,184,218,3756,38547,17257,"Falls County, Texas",145,48,21.75499566
2596,48147,Fannin County, Texas,41.7,33757,1971,306,0,306,701,35,666,568,146,422,396,211,185,5078,45471,21429,"Fannin County, Texas",147,48,15.04280594
2597,48149,Fayette County, Texas,47.7,24909,1702,117,24,93,253,44,209,679,287,392,653,214,439,2630,51290,28665,"Fayette County, Texas",149,48,10.5584327
2598,48151,Fisher County, Texas,43.4,3847,181,82,0,82,22,0,22,41,19,22,36,27,9,752,41531,26796,"Fisher County, Texas",151,48,19.54769951
2599,48153,Floyd County, Texas,37,6088,458,81,0,81,32,9,23,127,39,88,218,102,116,1330,43070,23133,"Floyd County, Texas",153,48,21.84625493
2600,48155,Foard County, Texas,49.5,1320,44,0,0,0,0,0,0,16,0,16,28,14,14,89,48068,23323,"Foard County, Texas",155,48,6.742424242
2601,48157,Fort Bend County, Texas,35.7,683756,185044,25795,2097,23698,54774,20762,34012,48143,31031,17112,56332,46539,9793,55523,91152,37134,"Fort Bend County, Texas",157,48,8.120294374
2602,48159,Franklin County, Texas,43.3,10571,735,0,0,0,214,4,210,111,16,95,410,181,229,1759,42652,25250,"Franklin County, Texas",159,48,16.63986378
2603,48161,Freestone County, Texas,41.4,19585,1356,196,26,170,430,63,367,331,15,316,399,208,191,2988,45134,23370,"Freestone County, Texas",161,48,15.25657391
2604,48163,Frio County, Texas,31.6,18542,2312,808,198,610,318,0,318,511,85,426,675,331,344,3333,37163,17547,"Frio County, Texas",163,48,17.97540718
2605,48165,Gaines County, Texas,28.4,19485,4698,874,93,781,929,130,799,988,421,567,1907,1175,732,2076,58788,22837,"Gaines County, Texas",165,48,10.6543495
2606,48167,Galveston County, Texas,37.5,314485,30410,2877,133,2744,9019,1697,7322,7976,3429,4547,10538,7442,3096,41948,63064,32756,"Galveston County, Texas",167,48,13.338633
2607,48169,Garza County, Texas,37.9,6614,2422,505,0,505,608,29,579,758,0,758,551,86,465,624,52708,19043,"Garza County, Texas",169,48,9.434532809
2608,48171,Gillespie County, Texas,50.1,25732,2515,439,5,434,376,43,333,647,386,261,1053,610,443,2725,55850,30939,"Gillespie County, Texas",171,48,10.58992694
2609,48173,Glasscock County, Texas,37.4,1253,245,0,0,0,99,29,70,74,18,56,72,37,35,66,62159,34834,"Glasscock County, Texas",173,48,5.26735834
2610,48175,Goliad County, Texas,45.7,7463,157,2,2,0,6,0,6,37,1,36,112,48,64,1246,54375,30581,"Goliad County, Texas",175,48,16.69569878
2611,48177,Gonzales County, Texas,37.3,20370,2863,78,0,78,1217,69,1148,674,101,573,894,333,561,3443,46630,22631,"Gonzales County, Texas",177,48,16.90230731
2612,48179,Gray County, Texas,36.8,23028,2287,109,57,52,815,52,763,541,151,390,822,517,305,3359,45264,22409,"Gray County, Texas",179,48,14.58659024
2613,48181,Grayson County, Texas,40.2,124231,7605,1077,19,1058,2591,410,2181,2038,752,1286,1899,1192,707,18877,50212,25541,"Grayson County, Texas",181,48,15.19508013
2614,48183,Gregg County, Texas,35.2,123283,11029,1526,29,1497,3990,673,3317,2994,636,2358,2519,1539,980,21785,47140,24386,"Gregg County, Texas",183,48,17.67072508
2615,48185,Grimes County, Texas,40.4,27140,2443,171,9,162,822,100,722,588,82,506,862,396,466,4819,47839,21173,"Grimes County, Texas",185,48,17.75607959
2616,48187,Guadalupe County, Texas,36.7,147313,11317,908,180,728,2614,794,1820,3261,1339,1922,4534,3264,1270,15190,64599,28310,"Guadalupe County, Texas",187,48,10.31137781
2617,48189,Hale County, Texas,32.7,35007,3451,215,0,215,872,138,734,842,244,598,1522,699,823,6740,44995,18888,"Hale County, Texas",189,48,19.2532922
2618,48191,Hall County, Texas,44.2,3162,333,12,0,12,98,10,88,127,1,126,96,61,35,889,27244,18453,"Hall County, Texas",191,48,28.11511701
2619,48193,Hamilton County, Texas,48.3,8232,281,79,0,79,19,0,19,36,13,23,147,93,54,1174,45105,26183,"Hamilton County, Texas",193,48,14.26141885
2620,48195,Hansford County, Texas,35.7,5552,1167,219,4,215,452,18,434,243,31,212,253,153,100,1096,41335,23605,"Hansford County, Texas",195,48,19.74063401
2621,48197,Hardeman County, Texas,43.3,3952,289,67,0,67,59,0,59,115,18,97,48,7,41,606,35156,19493,"Hardeman County, Texas",197,48,15.3340081
2622,48199,Hardin County, Texas,39.1,55624,1008,98,25,73,343,113,230,447,94,353,120,78,42,6480,54352,28321,"Hardin County, Texas",199,48,11.64964763
2623,48201,Harris County, Texas,32.9,4434257,1138017,164082,9210,154872,367011,71791,295220,287200,99963,187237,319724,207159,112565,763456,55584,29850,"Harris County, Texas",201,48,17.21722489
2624,48203,Harrison County, Texas,37.7,66431,4174,383,10,373,1394,194,1200,1522,336,1186,875,614,261,11499,46230,23836,"Harrison County, Texas",203,48,17.30968975
2625,48205,Hartley County, Texas,39.5,5966,556,67,29,38,208,20,188,120,27,93,161,74,87,326,64614,21642,"Hartley County, Texas",205,48,5.464297687
2626,48207,Haskell County, Texas,42.7,5812,1042,217,2,215,402,1,401,257,0,257,166,55,111,1000,41067,21072,"Haskell County, Texas",207,48,17.20578114
2627,48209,Hays County, Texas,31.1,185686,14734,2015,23,1992,4197,886,3311,3870,1416,2454,4652,2712,1940,28863,60495,28396,"Hays County, Texas",209,48,15.54398285
2628,48211,Hemphill County, Texas,33.4,4151,574,58,0,58,262,32,230,94,0,94,160,70,90,484,67773,29110,"Hemphill County, Texas",211,48,11.659841
2629,48213,Henderson County, Texas,43.7,79213,4464,793,32,761,994,142,852,1409,284,1125,1268,501,767,14593,43434,23605,"Henderson County, Texas",213,48,18.42248116
2630,48215,Hidalgo County, Texas,28.8,828334,230966,22749,1135,21614,66006,7288,58718,54168,11760,42408,88043,40826,47217,267812,36094,15240,"Hidalgo County, Texas",215,48,32.33140255
2631,48217,Hill County, Texas,42.5,34901,2589,172,2,170,839,65,774,822,240,582,756,441,315,6457,43441,22154,"Hill County, Texas",217,48,18.50090255
2632,48219,Hockley County, Texas,33,23377,1740,85,0,85,552,14,538,371,118,253,732,332,400,3540,50331,22718,"Hockley County, Texas",219,48,15.14308936
2633,48221,Hood County, Texas,46.8,54217,1749,476,36,440,589,175,414,327,150,177,357,222,135,6439,58315,31508,"Hood County, Texas",221,48,11.87634875
2634,48223,Hopkins County, Texas,39.2,35844,3013,166,12,154,617,100,517,1216,242,974,1014,692,322,6880,45748,23063,"Hopkins County, Texas",223,48,19.19428635
2635,48225,Houston County, Texas,44.5,22802,893,95,0,95,319,82,237,180,108,72,299,176,123,4801,32434,17624,"Houston County, Texas",225,48,21.0551706
2636,48227,Howard County, Texas,36.9,36423,3288,812,0,812,719,49,670,827,105,722,930,482,448,4646,50977,23054,"Howard County, Texas",227,48,12.75567636
2637,48229,Hudspeth County, Texas,40.1,3481,1290,318,0,318,156,6,150,270,33,237,546,209,337,1131,26635,14776,"Hudspeth County, Texas",229,48,32.4906636
2638,48231,Hunt County, Texas,38.1,89068,5518,912,20,892,1989,198,1791,1242,374,868,1375,877,498,16281,45643,22229,"Hunt County, Texas",231,48,18.27929223
2639,48233,Hutchinson County, Texas,36.5,21782,1114,29,0,29,402,52,350,277,130,147,406,234,172,3561,50114,25117,"Hutchinson County, Texas",233,48,16.34836103
2640,48235,Irion County, Texas,42.5,1631,72,0,0,0,0,0,0,15,15,0,57,47,10,191,64100,31096,"Irion County, Texas",235,48,11.71060699
2641,48237,Jack County, Texas,40,8866,492,8,0,8,212,0,212,124,42,82,148,37,111,1312,50390,24677,"Jack County, Texas",237,48,14.79810512
2642,48239,Jackson County, Texas,38.5,14678,1091,58,9,49,322,38,284,358,36,322,353,124,229,1863,56601,25594,"Jackson County, Texas",239,48,12.69246491
2643,48241,Jasper County, Texas,40.4,35640,978,24,23,1,402,62,340,318,127,191,234,103,131,5650,44552,21116,"Jasper County, Texas",241,48,15.85297419
2644,48243,Jeff Davis County, Texas,51.9,2221,438,41,0,41,215,0,215,118,19,99,64,35,29,172,50174,26493,"Jeff Davis County, Texas",243,48,7.744259343
2645,48245,Jefferson County, Texas,36,252993,29500,3765,244,3521,10423,1945,8478,7857,2673,5184,7455,4867,2588,47369,44965,24738,"Jefferson County, Texas",245,48,18.72344294
2646,48247,Jim Hogg County, Texas,36,5218,266,81,0,81,36,0,36,45,0,45,104,43,61,1088,34769,16637,"Jim Hogg County, Texas",247,48,20.85090073
2647,48249,Jim Wells County, Texas,34.2,41486,2515,402,0,402,500,116,384,497,156,341,1116,697,419,8471,43321,21556,"Jim Wells County, Texas",249,48,20.41893651
2648,48251,Johnson County, Texas,36.8,157544,9671,383,5,378,3091,156,2935,2594,795,1799,3603,2141,1462,18706,59095,25721,"Johnson County, Texas",251,48,11.87350835
2649,48253,Jones County, Texas,39,19944,669,20,0,20,67,5,62,289,60,229,293,40,253,2151,47007,17279,"Jones County, Texas",253,48,10.78519856
2650,48255,Karnes County, Texas,35.8,14984,888,311,10,301,164,60,104,150,21,129,263,142,121,2936,46058,25306,"Karnes County, Texas",255,48,19.59423385
2651,48257,Kaufman County, Texas,35.8,111830,8660,602,17,585,2145,305,1840,2845,735,2110,3068,1415,1653,15160,60179,25445,"Kaufman County, Texas",257,48,13.5562908
2652,48259,Kendall County, Texas,43.4,39010,2342,212,0,212,231,22,209,741,246,495,1158,683,475,2363,76350,36724,"Kendall County, Texas",259,48,6.057421174
2653,48261,Kenedy County, Texas,31.7,558,140,89,0,89,0,0,0,27,9,18,24,10,14,127,24000,13822,"Kenedy County, Texas",261,48,22.75985663
2654,48263,Kent County, Texas,48.6,667,11,0,0,0,0,0,0,0,0,0,11,5,6,72,50625,27434,"Kent County, Texas",263,48,10.7946027
2655,48265,Kerr County, Texas,48,50505,3636,454,13,441,837,55,782,734,165,569,1611,1284,327,8158,44261,26210,"Kerr County, Texas",265,48,16.15285615
2656,48267,Kimble County, Texas,54.5,4453,252,0,0,0,69,15,54,63,23,40,120,67,53,831,41263,26969,"Kimble County, Texas",267,48,18.66157647
2657,48269,King County, Texas,39.8,274,44,0,0,0,24,6,18,10,0,10,10,10,0,9,57083,30016,"King County, Texas",269,48,3.284671533
2658,48271,Kinney County, Texas,43.5,3578,754,188,0,188,136,18,118,137,69,68,293,123,170,654,34398,17818,"Kinney County, Texas",271,48,18.2783678
2659,48273,Kleberg County, Texas,28,31877,2245,606,113,493,489,67,422,325,115,210,825,543,282,7110,41469,19700,"Kleberg County, Texas",273,48,22.30448286
2660,48275,Knox County, Texas,41,3807,301,27,0,27,51,4,47,65,17,48,158,105,53,536,42188,19673,"Knox County, Texas",275,48,14.07932755
2661,48277,Lamar County, Texas,40.6,49626,2230,144,0,144,1158,319,839,492,190,302,436,385,51,9691,40283,22438,"Lamar County, Texas",277,48,19.52806996
2662,48279,Lamb County, Texas,36.3,13561,1348,118,7,111,374,96,278,280,84,196,576,358,218,2763,41401,20933,"Lamb County, Texas",279,48,20.37460364
2663,48281,Lampasas County, Texas,41.1,20357,1073,118,0,118,306,41,265,193,111,82,456,288,168,2751,50358,24382,"Lampasas County, Texas",281,48,13.51377904
2664,48283,La Salle County, Texas,33.1,7319,646,134,0,134,234,51,183,97,0,97,181,47,134,843,40094,23939,"La Salle County, Texas",283,48,11.51796694
2665,48285,Lavaca County, Texas,44.3,19654,1077,71,0,71,388,23,365,338,8,330,280,124,156,1995,47753,28491,"Lavaca County, Texas",285,48,10.15060547
2666,48287,Lee County, Texas,41,16754,1217,37,0,37,343,15,328,347,49,298,490,275,215,2402,54346,25549,"Lee County, Texas",287,48,14.33687478
2667,48289,Leon County, Texas,44.8,16923,1175,20,0,20,319,16,303,293,80,213,543,285,258,2694,47441,27271,"Leon County, Texas",289,48,15.91916327
2668,48291,Liberty County, Texas,36.2,78598,5995,795,0,795,1741,365,1376,1567,166,1401,1892,841,1051,12448,49655,22065,"Liberty County, Texas",291,48,15.83755312
2669,48293,Limestone County, Texas,39.1,23469,2298,242,7,235,695,64,631,605,53,552,756,357,399,4976,37431,20506,"Limestone County, Texas",293,48,21.20243726
2670,48295,Lipscomb County, Texas,34.8,3507,407,54,0,54,83,10,73,187,24,163,83,13,70,358,60163,29103,"Lipscomb County, Texas",295,48,10.20815512
2671,48297,Live Oak County, Texas,42.2,11976,932,135,0,135,189,15,174,162,26,136,446,152,294,1649,50741,22047,"Live Oak County, Texas",297,48,13.76920508
2672,48299,Llano County, Texas,56.4,19624,635,22,0,22,290,30,260,59,25,34,264,182,82,2672,48562,34633,"Llano County, Texas",299,48,13.61598043
2673,48301,Loving County, Texas,58.2,76,9,0,0,0,0,0,0,3,0,3,6,0,6,12,56875,32707,"Loving County, Texas",301,48,15.78947368
2674,48303,Lubbock County, Texas,30.6,294682,16599,2487,101,2386,5275,1614,3661,3872,1778,2094,4965,3230,1735,55027,46859,25139,"Lubbock County, Texas",303,48,18.67334958
2675,48305,Lynn County, Texas,37.2,5723,381,16,0,16,126,19,107,57,17,40,182,73,109,1128,40722,24299,"Lynn County, Texas",305,48,19.70994234
2676,48307,McCulloch County, Texas,43.9,8242,399,22,0,22,0,0,0,123,5,118,254,169,85,1484,40784,22049,"McCulloch County, Texas",307,48,18.00533851
2677,48309,McLennan County, Texas,33,243394,20614,3182,400,2782,5292,909,4383,5365,1328,4037,6775,3779,2996,46681,44246,22878,"McLennan County, Texas",309,48,19.17919094
2678,48311,McMullen County, Texas,39.6,671,45,34,0,34,0,0,0,11,0,11,0,0,0,59,57589,27971,"McMullen County, Texas",311,48,8.792846498
2679,48313,Madison County, Texas,35.5,13843,1156,132,0,132,304,39,265,311,47,264,409,167,242,1561,43209,17698,"Madison County, Texas",313,48,11.27645742
2680,48315,Marion County, Texas,49.2,10191,89,6,0,6,26,5,21,5,5,0,52,39,13,2161,35424,22536,"Marion County, Texas",315,48,21.20498479
2681,48317,Martin County, Texas,32,5451,444,5,0,5,197,22,175,112,9,103,130,68,62,571,63992,27692,"Martin County, Texas",317,48,10.47514218
2682,48319,Mason County, Texas,49.9,4064,369,88,0,88,84,8,76,58,4,54,139,36,103,604,38496,25834,"Mason County, Texas",319,48,14.86220472
2683,48321,Matagorda County, Texas,37.1,36719,3765,189,0,189,996,211,785,1174,411,763,1406,695,711,7877,41253,22939,"Matagorda County, Texas",321,48,21.45210926
2684,48323,Maverick County, Texas,29.7,56830,18794,2163,9,2154,3769,686,3083,2809,768,2041,10053,5067,4986,13879,37155,16086,"Maverick County, Texas",323,48,24.42196023
2685,48325,Medina County, Texas,38.6,47920,2454,253,0,253,224,71,153,587,209,378,1390,898,492,6340,58333,24731,"Medina County, Texas",325,48,13.23038397
2686,48327,Menard County, Texas,41.8,2163,93,26,0,26,0,0,0,13,0,13,54,23,31,282,37917,23331,"Menard County, Texas",327,48,13.03744799
2687,48329,Midland County, Texas,31.9,155817,17331,3174,234,2940,3600,706,2894,4024,1363,2661,6533,3452,3081,12148,71424,36869,"Midland County, Texas",329,48,7.796325176
2688,48331,Milam County, Texas,41.8,24372,1306,58,5,53,305,22,283,365,125,240,578,298,280,3692,39213,22132,"Milam County, Texas",331,48,15.1485311
2689,48333,Mills County, Texas,46.1,4871,347,20,0,20,33,0,33,118,52,66,176,44,132,678,44375,24099,"Mills County, Texas",333,48,13.91911312
2690,48335,Mitchell County, Texas,35.5,8995,634,29,0,29,187,24,163,187,12,175,231,72,159,654,51555,19334,"Mitchell County, Texas",335,48,7.270705948
2691,48337,Montague County, Texas,43.9,19384,1000,81,0,81,270,18,252,333,6,327,316,214,102,3066,46383,25403,"Montague County, Texas",337,48,15.8171688
2692,48339,Montgomery County, Texas,36.6,518849,67033,9517,505,9012,24457,4057,20400,17063,6061,11002,15996,11297,4699,56804,70805,35912,"Montgomery County, Texas",339,48,10.94807931
2693,48341,Moore County, Texas,31.1,22186,6108,386,8,378,2350,238,2112,1576,301,1275,1796,949,847,3908,50552,20159,"Moore County, Texas",341,48,17.61471198
2694,48343,Morris County, Texas,42.9,12653,443,15,8,7,208,15,193,117,20,97,103,46,57,2316,37902,21616,"Morris County, Texas",343,48,18.30395954
2695,48345,Motley County, Texas,48.9,1022,15,0,0,0,0,0,0,8,8,0,7,7,0,158,35433,23131,"Motley County, Texas",345,48,15.45988258
2696,48347,Nacogdoches County, Texas,30.4,65556,6086,495,31,464,2842,303,2539,1724,500,1224,1025,578,447,14631,38915,21343,"Nacogdoches County, Texas",347,48,22.31832327
2697,48349,Navarro County, Texas,38.1,48177,5431,290,14,276,1693,239,1454,1965,364,1601,1483,667,816,9418,43388,21347,"Navarro County, Texas",349,48,19.54874733
2698,48351,Newton County, Texas,40.7,14138,147,7,0,7,75,0,75,35,35,0,30,8,22,2272,36829,19293,"Newton County, Texas",351,48,16.07016551
2699,48353,Nolan County, Texas,38,15017,548,75,23,52,150,27,123,135,50,85,188,122,66,2572,38411,22240,"Nolan County, Texas",353,48,17.12725578
2700,48355,Nueces County, Texas,34.9,355667,29178,3815,305,3510,8141,2208,5933,5325,2153,3172,11897,7247,4650,59095,51882,25826,"Nueces County, Texas",355,48,16.6152609
2701,48357,Ochiltree County, Texas,31.2,10577,2183,269,0,269,772,84,688,629,146,483,513,243,270,1322,50011,24997,"Ochiltree County, Texas",357,48,12.49881819
2702,48359,Oldham County, Texas,33.2,2069,49,6,6,0,10,0,10,3,3,0,30,24,6,215,52292,23644,"Oldham County, Texas",359,48,10.39149348
2703,48361,Orange County, Texas,37.9,83751,2081,155,9,146,891,173,718,320,150,170,715,490,225,12590,51443,26611,"Orange County, Texas",361,48,15.03265633
2704,48363,Palo Pinto County, Texas,41.5,27922,1849,226,50,176,519,99,420,341,110,231,763,566,197,4916,42824,24891,"Palo Pinto County, Texas",363,48,17.60618867
2705,48365,Panola County, Texas,38.3,23771,992,62,0,62,440,121,319,319,24,295,171,54,117,3372,50712,25345,"Panola County, Texas",365,48,14.1853519
2706,48367,Parker County, Texas,39.7,123601,5539,982,46,936,1873,438,1435,1344,457,887,1340,1037,303,11377,67979,32274,"Parker County, Texas",367,48,9.204618086
2707,48369,Parmer County, Texas,33.5,9921,2016,253,31,222,687,125,562,556,119,437,520,282,238,1637,48589,21655,"Parmer County, Texas",369,48,16.50035279
2708,48371,Pecos County, Texas,35.4,15826,2216,59,0,59,513,84,429,401,131,270,1243,520,723,1334,51735,19738,"Pecos County, Texas",371,48,8.429167193
2709,48373,Polk County, Texas,43.4,46583,3046,601,0,601,796,107,689,722,125,597,927,445,482,7706,40864,21411,"Polk County, Texas",373,48,16.54251551
2710,48375,Potter County, Texas,33.3,121883,18286,2940,54,2886,5911,938,4973,4555,1188,3367,4880,2623,2257,25187,40340,20984,"Potter County, Texas",375,48,20.66489995
2711,48377,Presidio County, Texas,40.8,7144,2621,371,0,371,684,79,605,417,133,284,1149,484,665,1749,33453,16326,"Presidio County, Texas",377,48,24.48208287
2712,48379,Rains County, Texas,47.8,11087,438,76,7,69,91,35,56,121,12,109,150,119,31,1174,50405,23577,"Rains County, Texas",379,48,10.58897808
2713,48381,Randall County, Texas,35.5,128603,6123,884,70,814,2086,575,1511,1128,499,629,2025,1345,680,13245,62635,31383,"Randall County, Texas",381,48,10.29913766
2714,48383,Reagan County, Texas,34.9,3625,863,153,5,148,48,5,43,215,110,105,447,261,186,630,59257,25754,"Reagan County, Texas",383,48,17.37931034
2715,48385,Real County, Texas,55.5,3348,139,0,0,0,97,1,96,18,0,18,24,12,12,599,37059,21135,"Real County, Texas",385,48,17.89127838
2716,48387,Red River County, Texas,45.8,12455,288,1,0,1,36,0,36,114,14,100,137,117,20,2020,35016,20798,"Red River County, Texas",387,48,16.21838619
2717,48389,Reeves County, Texas,35.2,14438,3545,783,0,783,610,17,593,684,96,588,1468,400,1068,1697,46464,18458,"Reeves County, Texas",389,48,11.7537055
2718,48391,Refugio County, Texas,42.8,7315,200,0,0,0,80,0,80,75,16,59,45,26,19,1124,50145,24776,"Refugio County, Texas",391,48,15.36568694
2719,48393,Roberts County, Texas,35.6,939,13,0,0,0,0,0,0,0,0,0,13,13,0,17,72500,31655,"Roberts County, Texas",393,48,1.810436635
2720,48395,Robertson County, Texas,41.2,16537,1012,144,0,144,228,35,193,340,12,328,300,186,114,2460,49142,22980,"Robertson County, Texas",395,48,14.8757332
2721,48397,Rockwall County, Texas,37.2,88010,7390,755,209,546,2063,415,1648,1998,863,1135,2574,1830,744,5380,89161,37231,"Rockwall County, Texas",397,48,6.112941711
2722,48399,Runnels County, Texas,41.8,10411,380,47,0,47,67,32,35,98,19,79,168,109,59,1804,41339,22856,"Runnels County, Texas",399,48,17.32782634
2723,48401,Rusk County, Texas,38.4,53197,3738,338,3,335,1080,246,834,1428,337,1091,892,523,369,7945,47424,22704,"Rusk County, Texas",401,48,14.93505273
2724,48403,Sabine County, Texas,50.6,10367,78,0,0,0,34,0,34,15,12,3,29,28,1,2385,32500,20120,"Sabine County, Texas",403,48,23.00569114
2725,48405,San Augustine County, Texas,47.9,8556,199,12,0,12,54,0,54,72,10,62,61,46,15,2213,29426,19251,"San Augustine County, Texas",405,48,25.86489014
2726,48407,San Jacinto County, Texas,43.4,27172,1384,0,0,0,297,60,237,363,39,324,724,395,329,4627,44878,22563,"San Jacinto County, Texas",407,48,17.02855881
2727,48409,San Patricio County, Texas,35.3,66706,3876,551,6,545,913,276,637,847,275,572,1565,757,808,9397,52659,24008,"San Patricio County, Texas",409,48,14.08718856
2728,48411,San Saba County, Texas,41,5881,678,79,5,74,239,41,198,184,38,146,176,95,81,930,40718,19583,"San Saba County, Texas",411,48,15.81363714
2729,48413,Schleicher County, Texas,35.9,3171,448,4,0,4,164,36,128,104,22,82,176,117,59,417,59766,26408,"Schleicher County, Texas",413,48,13.15042573
2730,48415,Scurry County, Texas,35.4,17314,715,44,0,44,80,0,80,240,108,132,351,102,249,1261,55661,23758,"Scurry County, Texas",415,48,7.283123484
2731,48417,Shackelford County, Texas,41.8,3323,108,1,1,0,14,6,8,16,16,0,77,65,12,609,50285,24190,"Shackelford County, Texas",417,48,18.32681312
2732,48419,Shelby County, Texas,37.1,25705,2537,171,0,171,844,6,838,1131,169,962,391,102,289,5792,36312,20233,"Shelby County, Texas",419,48,22.53258121
2733,48421,Sherman County, Texas,37.9,3069,483,9,0,9,222,31,191,110,5,105,142,72,70,413,52969,23863,"Sherman County, Texas",421,48,13.45715217
2734,48423,Smith County, Texas,36.3,219745,17523,1892,131,1761,5185,775,4410,4756,1379,3377,5690,3154,2536,36474,48683,25299,"Smith County, Texas",423,48,16.59832988
2735,48425,Somervell County, Texas,40.7,8673,549,0,0,0,222,155,67,82,21,61,245,76,169,1485,50562,26547,"Somervell County, Texas",425,48,17.12210308
2736,48427,Starr County, Texas,28.7,63008,20374,1867,30,1837,3940,351,3589,3904,652,3252,10663,4833,5830,23445,26682,12663,"Starr County, Texas",427,48,37.20956069
2737,48429,Stephens County, Texas,38.5,9787,687,28,0,28,294,43,251,131,64,67,234,93,141,2012,45217,22307,"Stephens County, Texas",429,48,20.55788291
2738,48431,Sterling County, Texas,41.1,1233,137,0,0,0,39,0,39,30,7,23,68,14,54,184,50156,25104,"Sterling County, Texas",431,48,14.92295215
2739,48433,Stonewall County, Texas,49.6,1233,39,0,0,0,18,0,18,17,17,0,4,3,1,221,47969,24285,"Stonewall County, Texas",433,48,17.92376318
2740,48435,Sutton County, Texas,36.4,3936,386,88,6,82,58,32,26,61,15,46,179,60,119,358,54567,28140,"Sutton County, Texas",435,48,9.095528455
2741,48437,Swisher County, Texas,35.4,7639,422,17,7,10,90,2,88,135,70,65,180,69,111,1639,35167,18699,"Swisher County, Texas",437,48,21.45568792
2742,48439,Tarrant County, Texas,34.1,1947529,309724,39752,2731,37021,98498,21407,77091,86075,33377,52698,85399,56359,29040,275899,60373,29791,"Tarrant County, Texas",439,48,14.16661831
2743,48441,Taylor County, Texas,32.1,135234,7428,1371,153,1218,1950,824,1126,1265,509,756,2842,1762,1080,22653,47044,24328,"Taylor County, Texas",441,48,16.75096499
2744,48443,Terrell County, Texas,47.7,778,72,5,0,5,25,0,25,0,0,0,42,12,30,194,24821,25147,"Terrell County, Texas",443,48,24.93573265
2745,48445,Terry County, Texas,34.3,12724,1294,174,78,96,425,65,360,273,73,200,422,151,271,1581,40407,21936,"Terry County, Texas",445,48,12.42533794
2746,48447,Throckmorton County, Texas,51.3,1520,32,0,0,0,16,0,16,0,0,0,16,15,1,199,39438,28860,"Throckmorton County, Texas",447,48,13.09210526
2747,48449,Titus County, Texas,33.8,32592,6184,296,7,289,2232,242,1990,2058,388,1670,1598,760,838,6654,45026,20043,"Titus County, Texas",449,48,20.41605302
2748,48451,Tom Green County, Texas,34,116264,7668,370,0,370,1881,448,1433,1533,789,744,3884,2614,1270,15267,47637,26252,"Tom Green County, Texas",451,48,13.13132182
2749,48453,Travis County, Texas,33.3,1148176,201148,33489,2019,31470,71501,13981,57520,50230,19524,30706,45928,31266,14662,171023,64422,36649,"Travis County, Texas",453,48,14.89519028
2750,48455,Trinity County, Texas,48.1,14360,638,96,10,86,298,68,230,175,58,117,69,34,35,2206,35865,19661,"Trinity County, Texas",455,48,15.36211699
2751,48457,Tyler County, Texas,43,21371,479,37,30,7,185,9,176,114,18,96,143,42,101,2903,45427,20720,"Tyler County, Texas",457,48,13.58382855
2752,48459,Upshur County, Texas,40.6,40295,1229,15,0,15,420,14,406,435,62,373,359,183,176,5367,47724,23215,"Upshur County, Texas",459,48,13.31927038
2753,48461,Upton County, Texas,32.9,3475,444,23,0,23,132,5,127,48,4,44,241,108,133,695,48220,24254,"Upton County, Texas",461,48,20
2754,48463,Uvalde County, Texas,33.8,27055,3316,130,0,130,710,139,571,706,149,557,1770,794,976,5484,39011,18294,"Uvalde County, Texas",463,48,20.26982074
2755,48465,Val Verde County, Texas,31.6,48862,10686,1091,49,1042,1913,258,1655,1643,830,813,6039,3232,2807,9811,44170,19522,"Val Verde County, Texas",465,48,20.07899799
2756,48467,Van Zandt County, Texas,43.5,53070,2885,365,42,323,1090,191,899,617,254,363,813,608,205,8244,46555,24399,"Van Zandt County, Texas",467,48,15.53420011
2757,48469,Victoria County, Texas,35.5,90989,5767,755,85,670,1576,277,1299,1380,304,1076,2056,1236,820,13166,54697,27509,"Victoria County, Texas",469,48,14.46988097
2758,48471,Walker County, Texas,35.1,69926,5566,1038,6,1032,1643,349,1294,1427,480,947,1458,903,555,12072,40090,16419,"Walker County, Texas",471,48,17.26396476
2759,48473,Waller County, Texas,28.8,47049,6763,596,0,596,2723,228,2495,1363,196,1167,2081,1179,902,7986,53508,23338,"Waller County, Texas",473,48,16.97379328
2760,48475,Ward County, Texas,34.3,11396,952,142,12,130,116,16,100,169,21,148,525,297,228,1873,56796,26091,"Ward County, Texas",475,48,16.43559144
2761,48477,Washington County, Texas,42,34544,2953,98,10,88,1126,201,925,766,380,386,963,588,375,4645,52718,25976,"Washington County, Texas",477,48,13.44661881
2762,48479,Webb County, Texas,28.3,266006,70462,8623,368,8255,19335,2672,16663,16469,4436,12033,26035,12681,13354,84134,38711,15691,"Webb County, Texas",479,48,31.62860988
2763,48481,Wharton County, Texas,37.5,41377,3671,263,6,257,917,59,858,1198,210,988,1293,528,765,7228,46445,23245,"Wharton County, Texas",481,48,17.468642
2764,48483,Wheeler County, Texas,39.3,5642,537,34,0,34,275,3,272,135,26,109,93,37,56,951,51082,26736,"Wheeler County, Texas",483,48,16.85572492
2765,48485,Wichita County, Texas,34.1,132148,9040,1600,79,1521,3036,913,2123,1906,761,1145,2498,1745,753,21682,45371,23239,"Wichita County, Texas",485,48,16.40736144
2766,48487,Wilbarger County, Texas,37.5,13061,523,26,8,18,177,22,155,128,29,99,192,110,82,2086,43635,21638,"Wilbarger County, Texas",487,48,15.97121201
2767,48489,Willacy County, Texas,33.6,21944,3758,210,15,195,794,59,735,1030,220,810,1724,763,961,7371,28817,12564,"Willacy County, Texas",489,48,33.59004739
2768,48491,Williamson County, Texas,35.6,490619,56489,7233,367,6866,18439,5378,13061,13758,6996,6762,17059,12726,4333,35045,75935,32705,"Williamson County, Texas",491,48,7.14301729
2769,48493,Wilson County, Texas,40.4,46444,2083,214,46,168,298,61,237,385,145,240,1186,672,514,4795,68737,28419,"Wilson County, Texas",493,48,10.32426148
2770,48495,Winkler County, Texas,32.6,7723,1059,85,0,85,169,8,161,203,25,178,602,282,320,1319,54261,23051,"Winkler County, Texas",495,48,17.07885537
2771,48497,Wise County, Texas,38.8,62089,4712,288,0,288,1255,184,1071,1271,437,834,1898,880,1018,7599,56396,27104,"Wise County, Texas",497,48,12.23888289
2772,48499,Wood County, Texas,47.8,43198,1483,145,27,118,379,157,222,359,201,158,600,187,413,5556,47814,25353,"Wood County, Texas",499,48,12.86170656
2773,48501,Yoakum County, Texas,33.6,8316,2132,482,2,480,645,100,545,395,64,331,610,266,344,996,56655,22871,"Yoakum County, Texas",501,48,11.97691198
2774,48503,Young County, Texas,41.8,18275,985,116,0,116,486,78,408,160,47,113,223,136,87,2759,46978,25837,"Young County, Texas",503,48,15.09712722
2775,48505,Zapata County, Texas,29.3,14335,4183,306,48,258,1007,38,969,808,3,805,2062,644,1418,4857,36976,16007,"Zapata County, Texas",505,48,33.88210673
2776,48507,Zavala County, Texas,30.4,12107,1113,37,0,37,150,81,69,130,42,88,796,402,394,4248,26639,13393,"Zavala County, Texas",507,48,35.08713967
2777,49001,Beaver County, Utah,33.1,6437,321,26,0,26,162,11,151,35,11,24,98,56,42,743,48083,21394,"Beaver County, Utah",1,49,11.54264409
2778,49003,Box Elder County, Utah,32.1,51528,1452,84,4,80,335,110,225,269,116,153,764,601,163,5250,55514,21854,"Box Elder County, Utah",3,49,10.18863531
2779,49005,Cache County, Utah,25,118824,8452,1467,79,1388,3001,854,2147,2101,845,1256,1883,1179,704,17367,51935,21055,"Cache County, Utah",5,49,14.6157342
2780,49007,Carbon County, Utah,35.6,20733,616,85,0,85,138,3,135,175,64,111,218,173,45,3128,47793,21953,"Carbon County, Utah",7,49,15.08705928
2781,49009,Daggett County, Utah,48.7,751,20,2,0,2,0,0,0,9,0,9,9,9,0,30,75938,27182,"Daggett County, Utah",9,49,3.994673768
2782,49011,Davis County, Utah,30.4,329292,15449,1343,74,1269,4760,1576,3184,4678,2238,2440,4668,3951,717,23498,72661,27059,"Davis County, Utah",11,49,7.135915844
2783,49013,Duchesne County, Utah,30.2,20078,626,41,3,38,216,61,155,188,101,87,181,119,62,2381,61244,22941,"Duchesne County, Utah",13,49,11.85875087
2784,49015,Emery County, Utah,34.3,10570,170,0,0,0,59,8,51,53,4,49,58,52,6,1258,51276,20280,"Emery County, Utah",15,49,11.90160833
2785,49017,Garfield County, Utah,39.6,5020,162,29,0,29,90,0,90,25,12,13,18,9,9,647,45221,21006,"Garfield County, Utah",17,49,12.88844622
2786,49019,Grand County, Utah,39.7,9428,460,53,28,25,99,3,96,124,58,66,184,151,33,1579,43529,23927,"Grand County, Utah",19,49,16.74798473
2787,49021,Iron County, Utah,28.5,47751,2100,171,0,171,813,231,582,483,138,345,633,267,366,10107,43799,19085,"Iron County, Utah",21,49,21.16604888
2788,49023,Juab County, Utah,30.3,10507,151,0,0,0,38,12,26,79,2,77,34,16,18,1470,54861,19194,"Juab County, Utah",23,49,13.99067288
2789,49025,Kane County, Utah,43.4,7216,222,0,0,0,25,4,21,33,19,14,164,164,0,642,50517,24488,"Kane County, Utah",25,49,8.896895787
2790,49027,Millard County, Utah,34.9,12604,936,45,0,45,222,23,199,463,45,418,206,142,64,1288,53902,21643,"Millard County, Utah",27,49,10.2189781
2791,49029,Morgan County, Utah,32.3,10645,310,92,11,81,46,24,22,59,59,0,113,76,37,434,80865,27850,"Morgan County, Utah",29,49,4.07703147
2792,49031,Piute County, Utah,42.5,1859,19,0,0,0,15,3,12,4,0,4,0,0,0,304,37112,17416,"Piute County, Utah",31,49,16.35287789
2793,49033,Rich County, Utah,34.3,2284,32,18,0,18,14,0,14,0,0,0,0,0,0,359,52569,19749,"Rich County, Utah",33,49,15.71803853
2794,49035,Salt Lake County, Utah,32.1,1092518,135602,19984,926,19058,44413,10379,34034,40098,15258,24840,31107,22071,9036,122608,64601,28578,"Salt Lake County, Utah",35,49,11.22251533
2795,49037,San Juan County, Utah,30.6,15540,259,57,0,57,124,15,109,32,13,19,46,19,27,4171,41108,15817,"San Juan County, Utah",37,49,26.84041184
2796,49039,Sanpete County, Utah,31.2,28551,1169,131,1,130,239,25,214,383,85,298,416,188,228,4265,48866,16924,"Sanpete County, Utah",39,49,14.9381808
2797,49041,Sevier County, Utah,34.9,20913,416,40,11,29,142,17,125,108,27,81,126,103,23,2973,48872,20074,"Sevier County, Utah",41,49,14.21603787
2798,49043,Summit County, Utah,38.2,39009,3839,570,13,557,1352,298,1054,1017,450,567,900,548,352,3084,91470,49143,"Summit County, Utah",43,49,7.905867877
2799,49045,Tooele County, Utah,30.9,61986,2541,207,30,177,784,188,596,728,283,445,822,486,336,4429,64149,22978,"Tooele County, Utah",45,49,7.145161811
2800,49047,Uintah County, Utah,29.8,36308,1093,197,0,197,321,240,81,365,256,109,210,116,94,3406,67943,25488,"Uintah County, Utah",47,49,9.380852705
2801,49049,Utah County, Utah,24.4,564177,39395,5532,386,5146,14990,3015,11975,10012,4399,5613,8861,6338,2523,69019,64321,22088,"Utah County, Utah",49,49,12.23357209
2802,49051,Wasatch County, Utah,33.2,27895,2725,282,26,256,1374,131,1243,399,104,295,670,428,242,2441,71337,28818,"Wasatch County, Utah",51,49,8.750672163
2803,49053,Washington County, Utah,35.4,151959,8707,599,38,561,2831,617,2214,1954,428,1526,3323,2531,792,22151,52865,23549,"Washington County, Utah",53,49,14.57695826
2804,49055,Wayne County, Utah,40.1,2716,84,26,0,26,23,4,19,14,14,0,21,14,7,366,41684,21501,"Wayne County, Utah",55,49,13.47569956
2805,49057,Weber County, Utah,32.1,241328,17456,1955,232,1723,5102,984,4118,5050,1356,3694,5349,3488,1861,29410,59660,24226,"Weber County, Utah",57,49,12.18673341
2806,50001,Addison County, Vermont,43,36926,1620,267,6,261,440,139,301,273,226,47,640,497,143,2955,61020,30154,"Addison County, Vermont",1,50,8.002491469
2807,50003,Bennington County, Vermont,46.3,36503,958,189,1,188,239,126,113,110,98,12,420,300,120,4692,51489,30197,"Bennington County, Vermont",3,50,12.85373805
2808,50005,Caledonia County, Vermont,43.6,30859,561,84,17,67,115,42,73,83,22,61,279,192,87,3686,46931,24948,"Caledonia County, Vermont",5,50,11.94465148
2809,50007,Chittenden County, Vermont,36.4,160510,13158,2773,202,2571,4510,1667,2843,2690,2221,469,3185,2740,445,17335,66414,34658,"Chittenden County, Vermont",7,50,10.79995016
2810,50009,Essex County, Vermont,49.2,6173,224,5,5,0,23,14,9,22,5,17,174,106,68,912,39467,22191,"Essex County, Vermont",9,50,14.77401588
2811,50011,Franklin County, Vermont,39.7,48625,1362,188,0,188,171,95,76,226,167,59,777,600,177,4147,58884,28892,"Franklin County, Vermont",11,50,8.528534704
2812,50013,Grand Isle County, Vermont,47.4,6945,282,9,0,9,70,58,12,58,45,13,145,109,36,519,64295,35613,"Grand Isle County, Vermont",13,50,7.47300216
2813,50015,Lamoille County, Vermont,40.8,25136,826,88,0,88,283,64,219,152,65,87,303,165,138,3148,53316,29180,"Lamoille County, Vermont",15,50,12.52387015
2814,50017,Orange County, Vermont,45.4,28897,561,45,7,38,57,33,24,73,54,19,386,353,33,3477,54263,28691,"Orange County, Vermont",17,50,12.03239091
2815,50019,Orleans County, Vermont,45.1,27076,1093,70,16,54,164,50,114,155,101,54,704,563,141,3831,43959,24204,"Orleans County, Vermont",19,50,14.1490619
2816,50021,Rutland County, Vermont,45.9,60133,1436,147,11,136,346,73,273,266,184,82,677,538,139,7122,50029,27795,"Rutland County, Vermont",21,50,11.84374636
2817,50023,Washington County, Vermont,43.3,58963,2110,106,4,102,505,235,270,428,261,167,1071,802,269,6487,58171,31464,"Washington County, Vermont",23,50,11.0018147
2818,50025,Windham County, Vermont,46.2,43609,1355,166,0,166,189,82,107,192,138,54,808,642,166,5906,50917,28923,"Windham County, Vermont",25,50,13.54307597
2819,50027,Windsor County, Vermont,47.1,55894,2009,254,26,228,462,239,223,344,118,226,949,694,255,5456,54763,33257,"Windsor County, Vermont",27,50,9.761333954
2820,51001,Accomack County, Virginia,45.4,33060,2168,326,2,324,1086,68,1018,422,100,322,334,224,110,6341,38503,23337,"Accomack County, Virginia",1,51,19.18027828
2821,51003,Albemarle County, Virginia,38.9,104287,10343,1949,127,1822,3871,1007,2864,2048,1362,686,2475,2139,336,9341,70342,38039,"Albemarle County, Virginia",3,51,8.957012859
2822,51005,Alleghany County, Virginia,48,15919,207,15,0,15,95,0,95,15,15,0,82,61,21,2847,45538,25220,"Alleghany County, Virginia",5,51,17.88428921
2823,51007,Amelia County, Virginia,44.3,12793,31,0,0,0,0,0,0,15,0,15,16,16,0,1465,58269,25335,"Amelia County, Virginia",7,51,11.45157508
2824,51009,Amherst County, Virginia,43.9,31999,548,68,0,68,181,19,162,88,63,25,211,188,23,4405,47002,23372,"Amherst County, Virginia",9,51,13.76605519
2825,51011,Appomattox County, Virginia,42.8,15314,142,37,0,37,7,0,7,14,6,8,84,57,27,2633,52134,24902,"Appomattox County, Virginia",11,51,17.19341779
2826,51013,Arlington County, Virginia,34.1,226092,51434,10592,645,9947,17364,4729,12635,10052,6032,4020,13426,10597,2829,19528,108706,64746,"Arlington County, Virginia",13,51,8.63719194
2827,51015,Augusta County, Virginia,44.5,74330,1431,126,0,126,487,203,284,304,166,138,514,387,127,6550,56802,28601,"Augusta County, Virginia",15,51,8.812054352
2828,51017,Bath County, Virginia,47.2,4558,122,43,0,43,34,17,17,35,0,35,10,10,0,373,44985,28210,"Bath County, Virginia",17,51,8.183413778
2829,51019,Bedford County, Virginia,45.6,76933,1699,276,60,216,538,259,279,216,90,126,669,501,168,7028,56725,29561,"Bedford County, Virginia",19,51,9.135221556
2830,51021,Bland County, Virginia,44.9,6612,62,0,0,0,24,21,3,38,23,15,0,0,0,555,47800,22249,"Bland County, Virginia",21,51,8.393829401
2831,51023,Botetourt County, Virginia,46.9,33192,881,31,29,2,185,81,104,140,66,74,525,408,117,2732,61470,32518,"Botetourt County, Virginia",23,51,8.230899012
2832,51025,Brunswick County, Virginia,42.6,16573,321,115,0,115,30,0,30,80,33,47,96,82,14,3184,38858,19461,"Brunswick County, Virginia",25,51,19.21197128
2833,51027,Buchanan County, Virginia,45.9,23158,280,81,0,81,100,8,92,44,38,6,55,51,4,5297,30335,18160,"Buchanan County, Virginia",27,51,22.87330512
2834,51029,Buckingham County, Virginia,42.4,17030,298,8,0,8,58,25,33,131,48,83,101,90,11,2632,43514,19264,"Buckingham County, Virginia",29,51,15.45507927
2835,51031,Campbell County, Virginia,42.8,55061,1441,356,0,356,538,110,428,263,121,142,284,167,117,6799,47005,25219,"Campbell County, Virginia",31,51,12.34812299
2836,51033,Caroline County, Virginia,39.8,29640,847,89,50,39,202,71,131,236,127,109,320,272,48,3600,57294,26577,"Caroline County, Virginia",33,51,12.14574899
2837,51035,Carroll County, Virginia,46.7,29733,618,157,0,157,131,41,90,134,83,51,196,155,41,4625,37048,21484,"Carroll County, Virginia",35,51,15.55510712
2838,51036,Charles City County, Virginia,49.2,7086,118,7,0,7,34,17,17,11,9,2,66,46,20,1032,54167,30477,"Charles City County, Virginia",36,51,14.56392887
2839,51037,Charlotte County, Virginia,44.7,12232,81,7,2,5,26,3,23,5,5,0,43,42,1,2979,33837,18150,"Charlotte County, Virginia",37,51,24.35415304
2840,51041,Chesterfield County, Virginia,38.6,331839,26379,3054,201,2853,8533,2340,6193,6464,3590,2874,8328,6942,1386,24148,73869,33848,"Chesterfield County, Virginia",41,51,7.277022894
2841,51043,Clarke County, Virginia,45.4,14307,500,15,0,15,168,6,162,97,65,32,220,148,72,1587,71986,37630,"Clarke County, Virginia",43,51,11.09247222
2842,51045,Craig County, Virginia,47,5195,1,1,0,1,0,0,0,0,0,0,0,0,0,667,40500,22371,"Craig County, Virginia",45,51,12.83926853
2843,51047,Culpeper County, Virginia,38.9,48952,3748,450,21,429,1454,277,1177,978,322,656,866,699,167,4330,66160,28969,"Culpeper County, Virginia",47,51,8.845399575
2844,51049,Cumberland County, Virginia,44.4,9769,42,0,0,0,0,0,0,10,10,0,32,32,0,2204,37489,22126,"Cumberland County, Virginia",49,51,22.56116286
2845,51051,Dickenson County, Virginia,43.4,15304,89,9,0,9,41,0,41,4,4,0,35,22,13,3196,31226,20757,"Dickenson County, Virginia",51,51,20.88342917
2846,51053,Dinwiddie County, Virginia,42.2,28155,811,134,12,122,326,37,289,109,56,53,242,192,50,4375,51579,24001,"Dinwiddie County, Virginia",53,51,15.53898064
2847,51057,Essex County, Virginia,45,11130,168,44,0,44,50,27,23,12,12,0,62,62,0,1477,47527,25477,"Essex County, Virginia",57,51,13.27044025
2848,51059,Fairfax County, Virginia,37.6,1132887,343360,46615,3557,43058,111959,35479,76480,83653,56330,27323,101133,86471,14662,67306,114329,51851,"Fairfax County, Virginia",59,51,5.941104453
2849,51061,Fauquier County, Virginia,41.6,68025,4276,227,0,227,1206,243,963,1253,535,718,1590,1212,378,4042,91221,41921,"Fauquier County, Virginia",61,51,5.941933113
2850,51063,Floyd County, Virginia,45.8,15587,322,0,0,0,167,63,104,62,49,13,93,82,11,1832,47288,24121,"Floyd County, Virginia",63,51,11.75338423
2851,51065,Fluvanna County, Virginia,42.6,26046,741,13,0,13,178,13,165,176,128,48,374,221,153,1726,66425,30230,"Fluvanna County, Virginia",65,51,6.626737311
2852,51067,Franklin County, Virginia,45.4,56230,1219,67,0,67,269,80,189,551,79,472,332,261,71,7950,48720,26188,"Franklin County, Virginia",67,51,14.13836031
2853,51069,Frederick County, Virginia,40.3,82321,4942,293,19,274,1904,490,1414,1320,464,856,1425,1174,251,4800,68929,31555,"Frederick County, Virginia",69,51,5.830832959
2854,51071,Giles County, Virginia,43.6,16871,135,3,0,3,58,0,58,0,0,0,74,63,11,1970,47675,25333,"Giles County, Virginia",71,51,11.67684192
2855,51073,Gloucester County, Virginia,44.3,37021,819,67,10,57,84,29,55,123,62,61,545,457,88,2798,62878,31072,"Gloucester County, Virginia",73,51,7.557872559
2856,51075,Goochland County, Virginia,47.7,21979,769,19,12,7,140,82,58,195,108,87,415,380,35,1033,82326,45995,"Goochland County, Virginia",75,51,4.699940853
2857,51077,Grayson County, Virginia,48.2,15180,274,13,0,13,135,0,135,44,0,44,82,82,0,2899,31002,20190,"Grayson County, Virginia",77,51,19.09749671
2858,51079,Greene County, Virginia,40.4,19085,867,198,4,194,306,64,242,188,62,126,175,83,92,2076,61615,28647,"Greene County, Virginia",79,51,10.87765261
2859,51081,Greensville County, Virginia,41.2,11698,289,0,0,0,85,0,85,137,45,92,67,33,34,1534,40559,15988,"Greensville County, Virginia",81,51,13.11335271
2860,51083,Halifax County, Virginia,45.7,35305,533,21,0,21,254,88,166,115,52,63,143,106,37,6498,37001,20706,"Halifax County, Virginia",83,51,18.40532502
2861,51085,Hanover County, Virginia,42.4,102199,3530,514,21,493,1330,557,773,632,436,196,1054,909,145,6201,81170,35881,"Hanover County, Virginia",85,51,6.067574047
2862,51087,Henrico County, Virginia,38.1,321921,38195,7284,234,7050,14734,4812,9922,8561,6560,2001,7616,6552,1064,33818,63699,34993,"Henrico County, Virginia",87,51,10.5050618
2863,51089,Henry County, Virginia,46.2,52209,1485,34,0,34,499,91,408,612,254,358,340,228,112,9776,34992,20645,"Henry County, Virginia",89,51,18.72474095
2864,51091,Highland County, Virginia,59.8,2230,7,0,0,0,0,0,0,0,0,0,7,7,0,279,44877,28736,"Highland County, Virginia",91,51,12.51121076
2865,51093,Isle of Wight County, Virginia,44.4,36027,707,83,13,70,188,79,109,89,78,11,347,264,83,3901,66835,32090,"Isle of Wight County, Virginia",93,51,10.82799012
2866,51095,James City County, Virginia,45.9,71900,4802,607,54,553,1277,544,733,794,414,380,2124,1901,223,5595,80226,41314,"James City County, Virginia",95,51,7.781641168
2867,51097,King and Queen County, Virginia,45.8,7140,194,23,0,23,62,0,62,40,0,40,69,36,33,1013,48852,25392,"King and Queen County, Virginia",97,51,14.18767507
2868,51099,King George County, Virginia,37,25260,633,74,19,55,155,0,155,100,46,54,304,294,10,1395,84342,35201,"King George County, Virginia",99,51,5.522565321
2869,51101,King William County, Virginia,40.9,16156,304,52,0,52,96,53,43,11,11,0,145,145,0,1953,64297,29311,"King William County, Virginia",101,51,12.08838821
2870,51103,Lancaster County, Virginia,56.4,11055,225,37,0,37,3,2,1,44,17,27,141,124,17,1095,50118,32013,"Lancaster County, Virginia",103,51,9.905020353
2871,51105,Lee County, Virginia,43.2,24911,334,4,0,4,63,0,63,139,39,100,128,55,73,6080,31577,17820,"Lee County, Virginia",105,51,24.40688852
2872,51107,Loudoun County, Virginia,35.5,362435,84745,10466,796,9670,29237,11291,17946,23424,16360,7064,21618,19143,2475,14313,125672,48578,"Loudoun County, Virginia",107,51,3.949121912
2873,51109,Louisa County, Virginia,44,34350,1099,82,23,59,323,201,122,295,145,150,399,299,100,4086,54662,28767,"Louisa County, Virginia",109,51,11.89519651
2874,51111,Lunenburg County, Virginia,45.2,12450,513,38,26,12,341,108,233,81,70,11,53,38,15,2361,39911,18383,"Lunenburg County, Virginia",111,51,18.96385542
2875,51113,Madison County, Virginia,44.6,13122,236,55,0,55,92,34,58,25,11,14,64,44,20,1510,48271,27144,"Madison County, Virginia",113,51,11.50739217
2876,51115,Mathews County, Virginia,51.5,8848,117,4,0,4,26,0,26,56,56,0,31,31,0,843,64049,34918,"Mathews County, Virginia",115,51,9.527576854
2877,51117,Mecklenburg County, Virginia,48.2,31209,501,41,0,41,82,5,77,189,76,113,189,164,25,5328,40040,21492,"Mecklenburg County, Virginia",117,51,17.07199846
2878,51119,Middlesex County, Virginia,53.1,10728,131,13,0,13,6,0,6,22,15,7,90,76,14,1130,53093,29391,"Middlesex County, Virginia",119,51,10.53318419
2879,51121,Montgomery County, Virginia,27.9,97227,8218,2911,139,2772,2930,685,2245,1238,903,335,1139,813,326,21191,49712,26819,"Montgomery County, Virginia",121,51,21.79538606
2880,51125,Nelson County, Virginia,48.7,14831,492,50,0,50,112,31,81,19,9,10,311,207,104,2125,50994,29769,"Nelson County, Virginia",125,51,14.32809655
2881,51127,New Kent County, Virginia,44,20051,554,93,73,20,68,24,44,126,74,52,267,218,49,970,75303,35723,"New Kent County, Virginia",127,51,4.837663957
2882,51131,Northampton County, Virginia,48.4,12118,682,73,0,73,195,27,168,195,104,91,219,141,78,2568,37011,23331,"Northampton County, Virginia",131,51,21.19161578
2883,51133,Northumberland County, Virginia,55.5,12272,303,13,13,0,48,12,36,105,23,82,137,128,9,1343,54440,32238,"Northumberland County, Virginia",133,51,10.94361147
2884,51135,Nottoway County, Virginia,41.9,15641,939,143,0,143,619,513,106,110,42,68,67,17,50,3030,36849,19256,"Nottoway County, Virginia",135,51,19.37216291
2885,51137,Orange County, Virginia,42.1,34873,1684,140,0,140,712,153,559,162,113,49,670,552,118,3136,66990,30361,"Orange County, Virginia",137,51,8.992630402
2886,51139,Page County, Virginia,44.7,23759,455,22,0,22,48,17,31,126,46,80,259,221,38,3770,45030,22683,"Page County, Virginia",139,51,15.8676712
2887,51141,Patrick County, Virginia,48.4,18180,348,31,0,31,172,51,121,95,42,53,50,42,8,3968,35999,20526,"Patrick County, Virginia",141,51,21.82618262
2888,51143,Pittsylvania County, Virginia,46,62392,1364,140,18,122,557,157,400,292,120,172,375,306,69,9254,43087,22650,"Pittsylvania County, Virginia",143,51,14.83202975
2889,51145,Powhatan County, Virginia,44.3,28286,618,71,29,42,178,32,146,113,67,46,256,208,48,1431,77684,32770,"Powhatan County, Virginia",145,51,5.059039808
2890,51147,Prince Edward County, Virginia,31.5,23077,804,148,0,148,141,18,123,159,46,113,356,125,231,3355,42283,18789,"Prince Edward County, Virginia",147,51,14.53828487
2891,51149,Prince George County, Virginia,37,37664,1601,311,19,292,401,118,283,262,109,153,627,550,77,3231,64805,26721,"Prince George County, Virginia",149,51,8.578483432
2892,51153,Prince William County, Virginia,34.4,443630,101144,11627,1169,10458,34147,12790,21357,29214,17246,11968,26156,20534,5622,30869,98546,37063,"Prince William County, Virginia",153,51,6.958276041
2893,51155,Pulaski County, Virginia,45.6,34417,464,15,0,15,159,7,152,133,37,96,157,134,23,4491,49469,25738,"Pulaski County, Virginia",155,51,13.04878403
2894,51157,Rappahannock County, Virginia,49.1,7416,332,14,0,14,111,0,111,79,52,27,128,73,55,681,58026,34886,"Rappahannock County, Virginia",157,51,9.182847896
2895,51159,Richmond County, Virginia,43.5,8868,536,10,1,9,102,27,75,167,46,121,257,181,76,1173,44919,19191,"Richmond County, Virginia",159,51,13.22733424
2896,51161,Roanoke County, Virginia,43.7,93655,5180,812,79,733,1561,715,846,1220,760,460,1587,1326,261,7270,60380,32220,"Roanoke County, Virginia",161,51,7.7625327
2897,51163,Rockbridge County, Virginia,48.5,22450,499,93,46,47,84,56,28,70,31,39,252,209,43,3274,52478,29603,"Rockbridge County, Virginia",163,51,14.58351893
2898,51165,Rockingham County, Virginia,41.6,78427,4144,495,0,495,1597,429,1168,1411,542,869,641,415,226,8888,55029,27160,"Rockingham County, Virginia",165,51,11.33283181
2899,51167,Russell County, Virginia,44.1,27973,299,16,0,16,242,42,200,0,0,0,41,41,0,4710,38370,21171,"Russell County, Virginia",167,51,16.83766489
2900,51169,Scott County, Virginia,45.7,22378,220,29,2,27,36,31,5,35,21,14,120,64,56,4355,38017,20935,"Scott County, Virginia",169,51,19.46107784
2901,51171,Shenandoah County, Virginia,44.8,42857,2470,242,18,224,701,251,450,513,100,413,1014,479,535,4514,50450,26444,"Shenandoah County, Virginia",171,51,10.53270178
2902,51173,Smyth County, Virginia,44.3,31513,396,161,0,161,121,7,114,23,19,4,91,71,20,5477,38906,22161,"Smyth County, Virginia",173,51,17.38012884
2903,51175,Southampton County, Virginia,45.6,18291,101,14,0,14,8,5,3,39,25,14,40,14,26,2475,51032,24018,"Southampton County, Virginia",175,51,13.53124487
2904,51177,Spotsylvania County, Virginia,37.3,129181,9281,825,129,696,3155,1187,1968,2425,1463,962,2876,2419,457,10920,79742,32367,"Spotsylvania County, Virginia",177,51,8.45325551
2905,51179,Stafford County, Virginia,35,139548,12246,1342,255,1087,3399,1261,2138,3249,2081,1168,4256,3763,493,6880,97528,37782,"Stafford County, Virginia",179,51,4.930203228
2906,51181,Surry County, Virginia,48.2,6731,44,5,5,0,11,2,9,25,7,18,3,2,1,804,56632,25838,"Surry County, Virginia",181,51,11.94473332
2907,51183,Sussex County, Virginia,42.2,11733,340,9,0,9,84,0,84,91,23,68,156,69,87,1238,37917,16653,"Sussex County, Virginia",183,51,10.55143612
2908,51185,Tazewell County, Virginia,43.7,43367,355,35,0,35,174,5,169,43,33,10,103,65,38,7466,38238,23548,"Tazewell County, Virginia",185,51,17.21585537
2909,51187,Warren County, Virginia,40.8,38807,1247,79,8,71,310,83,227,279,184,95,579,446,133,3937,63734,29179,"Warren County, Virginia",187,51,10.14507692
2910,51191,Washington County, Virginia,45.3,54562,879,174,0,174,177,79,98,268,157,111,260,183,77,7569,43835,25287,"Washington County, Virginia",191,51,13.87229207
2911,51193,Westmoreland County, Virginia,46.5,17528,581,14,0,14,251,19,232,84,0,84,232,127,105,1940,51566,29824,"Westmoreland County, Virginia",193,51,11.06800548
2912,51195,Wise County, Virginia,40,40074,469,66,0,66,106,45,61,84,32,52,213,191,22,7865,36352,20896,"Wise County, Virginia",195,51,19.62619155
2913,51197,Wythe County, Virginia,43.9,29171,263,14,0,14,57,11,46,45,45,0,147,134,13,4677,42888,24431,"Wythe County, Virginia",197,51,16.03304652
2914,51199,York County, Virginia,39.5,66919,5410,960,35,925,1308,419,889,946,731,215,2196,1852,344,4052,83410,36722,"York County, Virginia",199,51,6.055081516
2915,51510,Alexandria city, Virginia,36.2,151473,42076,9766,291,9475,15636,4796,10840,8327,4304,4023,8347,6484,1863,14688,89200,55534,"Alexandria city, Virginia",510,51,9.696777644
2916,51520,Bristol city, Virginia,42,17340,221,26,0,26,103,18,85,67,26,41,25,25,0,3498,35801,21865,"Bristol city, Virginia",520,51,20.17301038
2917,51530,Buena Vista city, Virginia,35.1,6610,45,30,0,30,6,6,0,5,5,0,4,0,4,1694,29109,16405,"Buena Vista city, Virginia",530,51,25.62783661
2918,51540,Charlottesville city, Virginia,30.3,45538,5534,1925,49,1876,2194,425,1769,740,547,193,675,449,226,11153,50727,30729,"Charlottesville city, Virginia",540,51,24.49163336
2919,51550,Chesapeake city, Virginia,36.7,233194,11587,1884,256,1628,3165,1519,1646,2386,1550,836,4152,3656,496,21418,69978,30764,"Chesapeake city, Virginia",550,51,9.184627392
2920,51570,Colonial Heights city, Virginia,40.6,17554,1316,73,19,54,405,185,220,423,283,140,415,374,41,2241,49639,27209,"Colonial Heights city, Virginia",570,51,12.76632107
2921,51580,Covington city, Virginia,43,5650,105,41,16,25,42,35,7,5,5,0,17,17,0,1187,34703,21512,"Covington city, Virginia",580,51,21.00884956
2922,51590,Danville city, Virginia,41.5,42360,1377,265,8,257,479,123,356,299,214,85,334,296,38,9135,33721,21742,"Danville city, Virginia",590,51,21.56515581
2923,51595,Emporia city, Virginia,39.5,5565,199,0,0,0,187,13,174,1,1,0,11,11,0,1764,27169,18608,"Emporia city, Virginia",595,51,31.69811321
2924,51600,Fairfax city, Virginia,39.6,23620,6612,1232,164,1068,1935,576,1359,1504,919,585,1941,1552,389,1415,104065,45222,"Fairfax city, Virginia",600,51,5.990685859
2925,51610,Falls Church city, Virginia,38.9,13597,2238,318,21,297,509,223,286,460,372,88,951,880,71,365,115244,66104,"Falls Church city, Virginia",610,51,2.68441568
2926,51620,Franklin city, Virginia,38.7,8413,157,0,0,0,65,0,65,0,0,0,92,57,35,1383,38333,23182,"Franklin city, Virginia",620,51,16.43884465
2927,51630,Fredericksburg city, Virginia,29.5,27853,2549,583,56,527,967,466,501,526,325,201,473,391,82,4194,53980,30480,"Fredericksburg city, Virginia",630,51,15.05762395
2928,51640,Galax city, Virginia,45.1,6858,733,20,0,20,184,4,180,439,20,419,90,63,27,1642,31110,20796,"Galax city, Virginia",640,51,23.94284048
2929,51650,Hampton city, Virginia,35.6,136789,6324,1040,46,994,1612,809,803,1252,896,356,2420,2078,342,20596,49890,25943,"Hampton city, Virginia",650,51,15.05676626
2930,51660,Harrisonburg city, Virginia,24,51979,8617,2046,197,1849,2984,620,2364,2453,1166,1287,1134,894,240,14757,40494,18892,"Harrisonburg city, Virginia",660,51,28.39031147
2931,51670,Hopewell city, Virginia,36.5,22332,1016,235,39,196,368,77,291,162,45,117,251,149,102,4509,40814,21827,"Hopewell city, Virginia",670,51,20.19075766
2932,51678,Lexington city, Virginia,21.5,7036,277,90,0,90,76,37,39,74,70,4,37,27,10,653,34464,15745,"Lexington city, Virginia",678,51,9.280841387
2933,51680,Lynchburg city, Virginia,28.6,78755,4611,1771,195,1576,1637,514,1123,593,407,186,610,410,200,16598,40728,22016,"Lynchburg city, Virginia",680,51,21.07548727
2934,51683,Manassas city, Virginia,33.4,41149,11392,1237,35,1202,4573,1032,3541,3493,1516,1977,2089,1574,515,3557,74371,29365,"Manassas city, Virginia",683,51,8.644195485
2935,51685,Manassas Park city, Virginia,33.1,15827,5260,680,88,592,2182,455,1727,1305,478,827,1093,880,213,1364,75027,28851,"Manassas Park city, Virginia",685,51,8.618184116
2936,51690,Martinsville city, Virginia,42.7,13551,403,32,20,12,103,0,103,168,30,138,100,80,20,3159,31719,22221,"Martinsville city, Virginia",690,51,23.3119327
2937,51700,Newport News city, Virginia,32.9,181606,12887,2030,160,1870,4294,1266,3028,2396,1617,779,4167,3259,908,27776,50089,25520,"Newport News city, Virginia",700,51,15.29464886
2938,51710,Norfolk city, Virginia,30.2,245724,17480,3199,263,2936,5685,2128,3557,3747,2717,1030,4849,3753,1096,46307,45268,25450,"Norfolk city, Virginia",710,51,18.84512705
2939,51720,Norton city, Virginia,39.6,3978,187,21,10,11,100,32,68,9,9,0,57,57,0,1040,26000,19522,"Norton city, Virginia",720,51,26.14379085
2940,51730,Petersburg city, Virginia,38.8,31997,1108,26,0,26,429,101,328,245,56,189,408,335,73,9191,32169,20464,"Petersburg city, Virginia",730,51,28.72456793
2941,51735,Poquoson city, Virginia,43.4,12068,359,9,0,9,104,73,31,51,26,25,195,165,30,563,84643,39020,"Poquoson city, Virginia",735,51,4.665230361
2942,51740,Portsmouth city, Virginia,35,96071,2596,689,106,583,726,293,433,309,148,161,872,679,193,16897,47050,23878,"Portsmouth city, Virginia",740,51,17.58803385
2943,51750,Radford city, Virginia,22.7,17186,630,112,60,52,246,101,145,101,92,9,171,163,8,5580,31457,18108,"Radford city, Virginia",750,51,32.46828814
2944,51760,Richmond city, Virginia,33.2,216773,14080,2847,47,2800,5889,1267,4622,2682,1198,1484,2662,2178,484,52470,41187,29011,"Richmond city, Virginia",760,51,24.20504399
2945,51770,Roanoke city, Virginia,38.1,99329,7300,2071,48,2023,2819,435,2384,1302,464,838,1108,653,455,21610,39201,23611,"Roanoke city, Virginia",770,51,21.75598264
2946,51775,Salem city, Virginia,40.6,25290,804,258,29,229,195,68,127,132,76,56,219,205,14,2158,52351,28892,"Salem city, Virginia",775,51,8.533017003
2947,51790,Staunton city, Virginia,42.6,24234,744,228,14,214,252,89,163,106,85,21,158,91,67,3622,42948,26678,"Staunton city, Virginia",790,51,14.94594372
2948,51800,Suffolk city, Virginia,38.4,87061,3239,404,66,338,651,306,345,834,609,225,1350,1137,213,9914,65435,30331,"Suffolk city, Virginia",800,51,11.38741802
2949,51810,Virginia Beach city, Virginia,35.4,449733,40732,5473,526,4947,10139,4402,5737,8672,6388,2284,16448,13802,2646,35924,67719,33250,"Virginia Beach city, Virginia",810,51,7.987850569
2950,51820,Waynesboro city, Virginia,39.5,21366,1080,249,21,228,204,122,82,278,70,208,349,228,121,3351,45097,22967,"Waynesboro city, Virginia",820,51,15.68379669
2951,51830,Williamsburg city, Virginia,24.4,14988,1359,485,5,480,514,174,340,123,102,21,237,95,142,2476,50091,25548,"Williamsburg city, Virginia",830,51,16.51988257
2952,51840,Winchester city, Virginia,37,27349,3185,567,0,567,1179,78,1101,873,150,723,566,435,131,3847,46466,26984,"Winchester city, Virginia",840,51,14.06632784
2953,53001,Adams County, Washington,28.6,19100,4546,349,7,342,1472,6,1466,1426,190,1236,1299,700,599,4322,47554,17781,"Adams County, Washington",1,53,22.62827225
2954,53003,Asotin County, Washington,44.6,22113,400,19,13,6,46,32,14,88,48,40,247,180,67,3154,45550,25760,"Asotin County, Washington",3,53,14.26310315
2955,53005,Benton County, Washington,35.5,187519,18833,2172,99,2073,4967,1246,3721,5623,1890,3733,6071,4011,2060,25797,61147,29529,"Benton County, Washington",5,53,13.75700596
2956,53007,Chelan County, Washington,39.8,74761,8414,355,44,311,2496,411,2085,2687,854,1833,2876,1756,1120,9318,51845,26109,"Chelan County, Washington",7,53,12.46371771
2957,53009,Clallam County, Washington,50.3,72969,3562,444,51,393,763,244,519,740,302,438,1615,1205,410,11273,47180,26967,"Clallam County, Washington",9,53,15.4490263
2958,53011,Clark County, Washington,37.8,450893,46961,3338,316,3022,14381,5010,9371,15538,9187,6351,13704,10540,3164,45773,62879,30207,"Clark County, Washington",11,53,10.15163243
2959,53013,Columbia County, Washington,49.9,3971,190,55,15,40,37,9,28,29,24,5,69,33,36,577,42083,26536,"Columbia County, Washington",13,53,14.530345
2960,53015,Cowlitz County, Washington,41.7,102854,4502,455,22,433,1257,244,1013,923,403,520,1867,1240,627,17070,49127,24756,"Cowlitz County, Washington",15,53,16.59634044
2961,53017,Douglas County, Washington,37.1,40101,6346,584,0,584,1920,186,1734,1732,540,1192,2110,1134,976,5330,53758,23966,"Douglas County, Washington",17,53,13.29143912
2962,53019,Ferry County, Washington,48.2,7639,126,17,0,17,27,3,24,34,8,26,48,27,21,1771,39555,21146,"Ferry County, Washington",19,53,23.18366278
2963,53021,Franklin County, Washington,29.3,87810,19747,1491,18,1473,6674,705,5969,6233,1878,4355,5349,2217,3132,14019,58284,20997,"Franklin County, Washington",21,53,15.96515203
2964,53023,Garfield County, Washington,47.7,2231,31,14,0,14,6,2,4,0,0,0,11,8,3,250,51395,23313,"Garfield County, Washington",23,53,11.20573734
2965,53025,Grant County, Washington,32.3,92530,17813,2281,56,2225,5382,378,5004,5737,909,4828,4413,2001,2412,15441,50145,20409,"Grant County, Washington",25,53,16.68756079
2966,53027,Grays Harbor County, Washington,43,71233,3851,170,32,138,1195,113,1082,1244,479,765,1242,931,311,11269,44521,23799,"Grays Harbor County, Washington",27,53,15.81991493
2967,53029,Island County, Washington,44.3,80113,5801,465,49,416,1638,917,721,953,511,442,2745,2339,406,7362,60261,32503,"Island County, Washington",29,53,9.189519803
2968,53031,Jefferson County, Washington,56.2,30333,1485,139,11,128,186,65,121,194,133,61,966,669,297,3541,50928,30871,"Jefferson County, Washington",31,53,11.67375466
2969,53033,King County, Washington,37.2,2079550,448287,85804,3708,82096,139389,45759,93630,110936,73061,37875,112158,92819,19339,219317,78800,43629,"King County, Washington",33,53,10.5463682
2970,53035,Kitsap County, Washington,39.2,257488,16116,1426,238,1188,3273,1493,1780,3418,2304,1114,7999,6499,1500,26110,65017,32801,"Kitsap County, Washington",35,53,10.14027838
2971,53037,Kittitas County, Washington,33.7,42785,2638,475,0,475,569,166,403,791,427,364,803,631,172,8402,47898,25147,"Kittitas County, Washington",37,53,19.6377235
2972,53039,Klickitat County, Washington,45.5,20930,1258,127,0,127,651,56,595,199,55,144,281,140,141,3261,49633,23227,"Klickitat County, Washington",39,53,15.58050645
2973,53041,Lewis County, Washington,43.1,75724,3417,359,18,341,869,76,793,981,211,770,1208,843,365,12131,44526,22947,"Lewis County, Washington",41,53,16.02002007
2974,53043,Lincoln County, Washington,48.7,10326,186,7,0,7,21,4,17,39,21,18,119,66,53,1506,47676,25382,"Lincoln County, Washington",43,53,14.58454387
2975,53045,Mason County, Washington,45.9,61060,3616,516,29,487,1378,169,1209,700,159,541,1022,743,279,10136,51764,25628,"Mason County, Washington",45,53,16.60006551
2976,53047,Okanogan County, Washington,43,41299,4405,414,14,400,1611,172,1439,1028,199,829,1352,867,485,8637,41158,22544,"Okanogan County, Washington",47,53,20.91333931
2977,53049,Pacific County, Washington,52.2,20743,1270,103,7,96,334,95,239,339,110,229,494,328,166,3829,38387,22187,"Pacific County, Washington",49,53,18.45923926
2978,53051,Pend Oreille County, Washington,49.8,13001,356,40,0,40,113,41,72,22,2,20,181,143,38,2543,46036,24163,"Pend Oreille County, Washington",51,53,19.56003384
2979,53053,Pierce County, Washington,36,832896,79240,8000,896,7104,22531,8301,14230,18767,10457,8310,29942,23534,6408,103562,61468,29750,"Pierce County, Washington",53,53,12.43396535
2980,53055,San Juan County, Washington,55.1,16056,1085,152,22,130,190,57,133,227,79,148,516,399,117,1749,58029,40327,"San Juan County, Washington",55,53,10.89312407
2981,53057,Skagit County, Washington,41.3,120475,11842,1740,55,1685,3038,443,2595,3242,933,2309,3822,2482,1340,17805,56433,28586,"Skagit County, Washington",57,53,14.77899979
2982,53059,Skamania County, Washington,45.4,11316,522,47,0,47,101,33,68,151,64,87,223,87,136,1597,53082,28556,"Skamania County, Washington",59,53,14.11276069
2983,53061,Snohomish County, Washington,37.8,758649,113624,12838,779,12059,36215,13366,22849,31401,18920,12481,33170,26781,6389,69695,73528,33883,"Snohomish County, Washington",61,53,9.18672535
2984,53063,Spokane County, Washington,37.3,485859,26787,3537,157,3380,7883,3136,4747,7860,4818,3042,7507,5495,2012,73462,50550,26860,"Spokane County, Washington",63,53,15.12002453
2985,53065,Stevens County, Washington,46.4,43744,1257,43,0,43,303,183,120,288,133,155,623,468,155,7133,44115,22745,"Stevens County, Washington",65,53,16.30623628
2986,53067,Thurston County, Washington,38.8,266311,20432,2179,207,1972,5181,1931,3250,4576,2727,1849,8496,7085,1411,31605,62854,30583,"Thurston County, Washington",67,53,11.86770355
2987,53069,Wahkiakum County, Washington,53.1,4051,142,32,0,32,37,18,19,8,0,8,65,52,13,562,48116,27619,"Wahkiakum County, Washington",69,53,13.87311775
2988,53071,Walla Walla County, Washington,37.3,59809,5942,427,8,419,1971,155,1816,1531,272,1259,2013,1031,982,8971,48705,24736,"Walla Walla County, Washington",71,53,14.9994148
2989,53073,Whatcom County, Washington,36.8,209729,22576,2532,196,2336,6107,2100,4007,5770,3482,2288,8167,5942,2225,32649,54207,27810,"Whatcom County, Washington",73,53,15.567232
2990,53075,Whitman County, Washington,24.2,47494,4701,1767,0,1767,1276,258,1018,1100,602,498,558,467,91,12246,38636,20957,"Whitman County, Washington",75,53,25.7843096
2991,53077,Yakima County, Washington,32.6,247681,44878,2522,109,2413,13189,1057,12132,14260,2847,11413,14907,7195,7712,50081,45700,20653,"Yakima County, Washington",77,53,20.21996035
2992,54001,Barbour County, West Virginia,41.1,16892,48,3,0,3,26,6,20,9,6,3,10,8,2,3657,36733,18602,"Barbour County, West Virginia",1,54,21.64930144
2993,54003,Berkeley County, West Virginia,38.4,110173,3728,256,0,256,1279,194,1085,517,416,101,1676,1351,325,14436,57148,27015,"Berkeley County, West Virginia",3,54,13.10302887
2994,54005,Boone County, West Virginia,42,23645,61,0,0,0,11,11,0,0,0,0,50,39,11,6090,37820,20711,"Boone County, West Virginia",5,54,25.75597378
2995,54007,Braxton County, West Virginia,45,14463,26,0,0,0,8,0,8,0,0,0,18,18,0,2842,38092,20178,"Braxton County, West Virginia",7,54,19.65014174
2996,54009,Brooke County, West Virginia,46.2,23473,222,23,0,23,29,18,11,28,6,22,142,109,33,2851,46265,24428,"Brooke County, West Virginia",9,54,12.14586972
2997,54011,Cabell County, West Virginia,38.3,96623,1626,506,32,474,248,93,155,313,253,60,559,499,60,20249,37760,23853,"Cabell County, West Virginia",11,54,20.95670803
2998,54013,Calhoun County, West Virginia,47.6,7482,61,0,0,0,1,0,1,22,0,22,38,24,14,1176,39384,20640,"Calhoun County, West Virginia",13,54,15.71772253
2999,54015,Clay County, West Virginia,43.4,9033,22,0,0,0,22,0,22,0,0,0,0,0,0,2073,33639,16980,"Clay County, West Virginia",15,54,22.94918632
3000,54017,Doddridge County, West Virginia,41.9,8363,67,28,0,28,4,0,4,6,6,0,29,14,15,1186,39381,19703,"Doddridge County, West Virginia",17,54,14.18151381
3001,54019,Fayette County, West Virginia,43.4,45192,311,64,0,64,87,22,65,25,7,18,135,115,20,8306,37846,20286,"Fayette County, West Virginia",19,54,18.37935918
3002,54021,Gilmer County, West Virginia,37.8,8497,219,26,0,26,36,8,28,73,0,73,84,16,68,1741,37286,17361,"Gilmer County, West Virginia",21,54,20.48958456
3003,54023,Grant County, West Virginia,46.2,11770,7,0,0,0,5,5,0,0,0,0,2,2,0,1525,38703,20648,"Grant County, West Virginia",23,54,12.9566695
3004,54025,Greenbrier County, West Virginia,45.4,35580,407,188,47,141,80,18,62,88,34,54,51,48,3,6398,40026,23204,"Greenbrier County, West Virginia",25,54,17.98201237
3005,54027,Hampshire County, West Virginia,45.1,23455,154,0,0,0,30,17,13,85,38,47,39,39,0,3864,32177,19997,"Hampshire County, West Virginia",27,54,16.47409934
3006,54029,Hancock County, West Virginia,45.7,30024,467,113,0,113,51,6,45,91,47,44,212,162,50,4286,40316,24041,"Hancock County, West Virginia",29,54,14.27524647
3007,54031,Hardy County, West Virginia,44.7,13942,532,264,81,183,130,61,69,0,0,0,138,138,0,1897,39840,21956,"Hardy County, West Virginia",31,54,13.60636924
3008,54033,Harrison County, West Virginia,41.8,68775,612,21,0,21,215,123,92,91,88,3,285,272,13,10743,44845,25702,"Harrison County, West Virginia",33,54,15.62050164
3009,54035,Jackson County, West Virginia,42.9,29199,272,89,0,89,0,0,0,23,4,19,160,160,0,4315,40949,22591,"Jackson County, West Virginia",35,54,14.77790335
3010,54037,Jefferson County, West Virginia,40.1,55531,2837,231,6,225,771,359,412,747,483,264,1088,828,260,5884,69753,32227,"Jefferson County, West Virginia",37,54,10.59588338
3011,54039,Kanawha County, West Virginia,42.9,189636,3190,534,46,488,911,397,514,429,344,85,1316,1145,171,29779,46528,28030,"Kanawha County, West Virginia",39,54,15.703242
3012,54041,Lewis County, West Virginia,43.4,16422,240,39,0,39,81,0,81,17,17,0,103,100,3,3142,37827,20954,"Lewis County, West Virginia",41,54,19.13287054
3013,54043,Lincoln County, West Virginia,42.9,21482,60,0,0,0,7,0,7,40,40,0,13,13,0,5394,36232,19416,"Lincoln County, West Virginia",43,54,25.10939391
3014,54045,Logan County, West Virginia,42.9,35166,157,0,0,0,31,10,21,69,8,61,57,57,0,6986,37262,20843,"Logan County, West Virginia",45,54,19.86577945
3015,54047,McDowell County, West Virginia,44.3,20273,246,57,0,57,80,0,80,65,0,65,44,19,25,7076,25206,14259,"McDowell County, West Virginia",47,54,34.90356632
3016,54049,Marion County, West Virginia,41.3,56716,649,94,36,58,163,9,154,142,53,89,250,216,34,9222,46430,24250,"Marion County, West Virginia",49,54,16.25996192
3017,54051,Marshall County, West Virginia,44.5,32296,301,0,0,0,76,64,12,133,110,23,92,92,0,4600,44464,23166,"Marshall County, West Virginia",51,54,14.24324994
3018,54053,Mason County, West Virginia,43.6,27060,176,1,0,1,121,2,119,0,0,0,54,54,0,4970,37322,20253,"Mason County, West Virginia",53,54,18.36659276
3019,54055,Mercer County, West Virginia,42.4,61476,658,137,0,137,71,13,58,161,113,48,289,261,28,12712,37255,21190,"Mercer County, West Virginia",55,54,20.67798816
3020,54057,Mineral County, West Virginia,43.3,27606,141,71,0,71,24,0,24,0,0,0,46,43,3,4386,36153,20093,"Mineral County, West Virginia",57,54,15.88785047
3021,54059,Mingo County, West Virginia,41.6,25549,95,0,0,0,95,0,95,0,0,0,0,0,0,6594,32441,19502,"Mingo County, West Virginia",59,54,25.80922932
3022,54061,Monongalia County, West Virginia,30.6,102827,5567,2381,40,2341,1361,261,1100,910,823,87,915,675,240,21353,47060,28041,"Monongalia County, West Virginia",61,54,20.76594669
3023,54063,Monroe County, West Virginia,47,13496,66,42,0,42,24,24,0,0,0,0,0,0,0,2283,35995,21257,"Monroe County, West Virginia",63,54,16.9161233
3024,54065,Morgan County, West Virginia,46.6,17514,304,0,0,0,144,33,111,0,0,0,160,159,1,1962,43234,23966,"Morgan County, West Virginia",65,54,11.2024666
3025,54067,Nicholas County, West Virginia,44.5,25743,264,62,0,62,17,17,0,16,0,16,169,169,0,4486,39901,24244,"Nicholas County, West Virginia",67,54,17.42609641
3026,54069,Ohio County, West Virginia,43.2,43257,760,103,0,103,186,79,107,121,68,53,350,265,85,6626,41986,28160,"Ohio County, West Virginia",69,54,15.31775204
3027,54071,Pendleton County, West Virginia,49.6,7291,34,0,0,0,0,0,0,0,0,0,34,13,21,1307,37035,23325,"Pendleton County, West Virginia",71,54,17.9262104
3028,54073,Pleasants County, West Virginia,43.9,7612,11,0,0,0,0,0,0,0,0,0,11,11,0,1187,45191,23580,"Pleasants County, West Virginia",73,54,15.59379926
3029,54075,Pocahontas County, West Virginia,48.3,8620,76,0,0,0,22,6,16,11,0,11,43,43,0,1545,36026,22328,"Pocahontas County, West Virginia",75,54,17.92343387
3030,54077,Preston County, West Virginia,42.4,33793,339,0,0,0,47,23,24,110,8,102,182,102,80,4761,45221,21716,"Preston County, West Virginia",77,54,14.0887166
3031,54079,Putnam County, West Virginia,41.4,56743,629,78,14,64,172,83,89,84,66,18,295,275,20,5546,56640,29173,"Putnam County, West Virginia",79,54,9.773892815
3032,54081,Raleigh County, West Virginia,41.5,78051,1312,232,12,220,318,172,146,316,69,247,446,375,71,13173,41533,22590,"Raleigh County, West Virginia",81,54,16.8774263
3033,54083,Randolph County, West Virginia,43.1,29287,196,53,0,53,70,54,16,27,19,8,46,30,16,4568,40308,22079,"Randolph County, West Virginia",83,54,15.59736402
3034,54085,Ritchie County, West Virginia,45.3,10044,17,2,0,2,0,0,0,0,0,0,15,15,0,1919,40850,20711,"Ritchie County, West Virginia",85,54,19.10593389
3035,54087,Roane County, West Virginia,44.2,14513,72,14,0,14,20,20,0,16,16,0,22,22,0,2870,34144,18954,"Roane County, West Virginia",87,54,19.7753738
3036,54089,Summers County, West Virginia,46.5,13325,58,1,0,1,0,0,0,22,10,12,35,35,0,2254,35620,19652,"Summers County, West Virginia",89,54,16.91557223
3037,54091,Taylor County, West Virginia,43.1,16949,127,21,11,10,18,9,9,19,0,19,69,43,26,2729,44371,22915,"Taylor County, West Virginia",91,54,16.10124491
3038,54093,Tucker County, West Virginia,47.9,6922,41,0,0,0,0,0,0,0,0,0,41,41,0,899,43529,22958,"Tucker County, West Virginia",93,54,12.98757585
3039,54095,Tyler County, West Virginia,46.3,9000,21,0,0,0,0,0,0,4,0,4,17,6,11,1663,38674,22083,"Tyler County, West Virginia",95,54,18.47777778
3040,54097,Upshur County, West Virginia,41.5,24632,156,49,0,49,0,0,0,28,19,9,79,37,42,4154,42240,21361,"Upshur County, West Virginia",97,54,16.86424164
3041,54099,Wayne County, West Virginia,42.7,41237,249,12,0,12,127,84,43,48,26,22,62,41,21,8566,38311,20450,"Wayne County, West Virginia",99,54,20.77260712
3042,54101,Webster County, West Virginia,46.2,8820,24,0,0,0,0,0,0,0,0,0,24,24,0,2383,29982,18652,"Webster County, West Virginia",101,54,27.01814059
3043,54103,Wetzel County, West Virginia,45.6,15997,71,0,0,0,45,0,45,18,18,0,8,8,0,3340,39446,21484,"Wetzel County, West Virginia",103,54,20.8789148
3044,54105,Wirt County, West Virginia,44.8,5826,0,0,0,0,0,0,0,0,0,0,0,0,0,876,38101,22021,"Wirt County, West Virginia",105,54,15.03604531
3045,54107,Wood County, West Virginia,42.6,86262,864,64,13,51,184,70,114,187,86,101,429,370,59,14747,43944,25465,"Wood County, West Virginia",107,54,17.0955925
3046,54109,Wyoming County, West Virginia,43.1,22537,58,0,0,0,0,0,0,0,0,0,58,58,0,4483,35469,19833,"Wyoming County, West Virginia",109,54,19.89173359
3047,55001,Adams County, Wisconsin,52.2,20294,563,32,8,24,92,33,59,73,36,37,366,237,129,2420,43554,23668,"Adams County, Wisconsin",1,55,11.92470681
3048,55003,Ashland County, Wisconsin,41.6,15936,174,40,0,40,17,3,14,6,2,4,111,84,27,2347,40297,22270,"Ashland County, Wisconsin",3,55,14.72766064
3049,55005,Barron County, Wisconsin,44.1,45548,1081,63,0,63,575,198,377,119,45,74,324,272,52,5467,46863,25426,"Barron County, Wisconsin",5,55,12.0027224
3050,55007,Bayfield County, Wisconsin,51.2,14987,256,25,0,25,94,53,41,34,15,19,103,69,34,1693,48132,27321,"Bayfield County, Wisconsin",7,55,11.29645693
3051,55009,Brown County, Wisconsin,36.8,256621,14413,1904,140,1764,5195,1382,3813,3463,1180,2283,3851,2535,1316,29105,54172,28787,"Brown County, Wisconsin",9,55,11.34162832
3052,55011,Buffalo County, Wisconsin,45.4,13256,209,79,1,78,40,12,28,29,13,16,61,50,11,1424,52447,26973,"Buffalo County, Wisconsin",11,55,10.74230537
3053,55013,Burnett County, Wisconsin,51.6,15259,190,15,7,8,64,21,43,19,14,5,92,66,26,2402,42441,25073,"Burnett County, Wisconsin",13,55,15.74152959
3054,55015,Calumet County, Wisconsin,39.4,49653,1530,152,3,149,421,206,215,539,406,133,418,380,38,3129,70042,30856,"Calumet County, Wisconsin",15,55,6.301734034
3055,55017,Chippewa County, Wisconsin,41,63355,676,49,15,34,234,94,140,87,64,23,306,192,114,6753,52657,26299,"Chippewa County, Wisconsin",17,55,10.65898508
3056,55019,Clark County, Wisconsin,37.3,34486,934,109,10,99,482,86,396,165,31,134,178,101,77,5060,46783,22560,"Clark County, Wisconsin",19,55,14.67262077
3057,55021,Columbia County, Wisconsin,42.2,56650,1169,157,0,157,314,122,192,345,216,129,353,291,62,4729,61004,29936,"Columbia County, Wisconsin",21,55,8.347749338
3058,55023,Crawford County, Wisconsin,46.1,16415,145,35,3,32,16,3,13,27,22,5,67,58,9,2123,45780,23466,"Crawford County, Wisconsin",23,55,12.93329272
3059,55025,Dane County, Wisconsin,34.7,516818,42667,10110,395,9715,14371,3934,10437,9351,4687,4664,8835,7255,1580,63673,64773,35687,"Dane County, Wisconsin",25,55,12.32019783
3060,55027,Dodge County, Wisconsin,42.1,88404,1666,130,5,125,492,120,372,447,132,315,597,400,197,7384,54111,25617,"Dodge County, Wisconsin",27,55,8.352563232
3061,55029,Door County, Wisconsin,52.2,27669,697,102,4,98,247,66,181,105,56,49,243,185,58,2451,53980,32767,"Door County, Wisconsin",29,55,8.85828906
3062,55031,Douglas County, Wisconsin,41,43705,705,210,5,205,164,107,57,99,64,35,232,192,40,6577,48190,26036,"Douglas County, Wisconsin",31,55,15.04862144
3063,55033,Dunn County, Wisconsin,34.5,44348,1120,316,26,290,345,178,167,216,156,60,243,172,71,5768,51787,25120,"Dunn County, Wisconsin",33,55,13.00622351
3064,55035,Eau Claire County, Wisconsin,34,101907,3379,810,112,698,1060,489,571,512,367,145,997,837,160,14233,50538,26795,"Eau Claire County, Wisconsin",35,55,13.96665587
3065,55037,Florence County, Wisconsin,52.1,4474,39,0,0,0,0,0,0,12,0,12,27,27,0,353,46595,28358,"Florence County, Wisconsin",37,55,7.890031292
3066,55039,Fond du Lac County, Wisconsin,41.1,101968,3620,912,38,874,1443,194,1249,584,169,415,681,493,188,8497,56376,28036,"Fond du Lac County, Wisconsin",39,55,8.333006433
3067,55041,Forest County, Wisconsin,46.2,9108,101,10,0,10,42,10,32,32,5,27,17,14,3,1520,41378,22559,"Forest County, Wisconsin",41,55,16.68862538
3068,55043,Grant County, Wisconsin,36,51723,834,222,0,222,310,146,164,133,95,38,169,139,30,7335,49077,23103,"Grant County, Wisconsin",43,55,14.18131199
3069,55045,Green County, Wisconsin,42.6,37050,913,163,3,160,342,128,214,112,45,67,296,198,98,3243,57416,28867,"Green County, Wisconsin",45,55,8.753036437
3070,55047,Green Lake County, Wisconsin,45.4,18881,702,12,8,4,308,102,206,246,67,179,136,83,53,2076,47174,26115,"Green Lake County, Wisconsin",47,55,10.99518034
3071,55049,Iowa County, Wisconsin,42.9,23751,295,49,0,49,74,19,55,52,23,29,120,101,19,2277,56641,29610,"Iowa County, Wisconsin",49,55,9.586964759
3072,55051,Iron County, Wisconsin,53.2,5850,59,0,0,0,9,2,7,8,6,2,42,33,9,726,41270,25536,"Iron County, Wisconsin",51,55,12.41025641
3073,55053,Jackson County, Wisconsin,42,20566,283,29,8,21,85,17,68,74,26,48,95,90,5,2536,49608,24074,"Jackson County, Wisconsin",53,55,12.3310318
3074,55055,Jefferson County, Wisconsin,39.5,84538,3294,349,0,349,1156,281,875,815,337,478,974,649,325,8350,57290,27272,"Jefferson County, Wisconsin",55,55,9.87721498
3075,55057,Juneau County, Wisconsin,44.8,26399,574,15,4,11,123,73,50,115,41,74,321,229,92,3244,47243,23519,"Juneau County, Wisconsin",57,55,12.28834426
3076,55059,Kenosha County, Wisconsin,37.6,167896,10378,706,32,674,3350,1194,2156,2482,1256,1226,3840,2981,859,24708,56086,27335,"Kenosha County, Wisconsin",59,55,14.71625292
3077,55061,Kewaunee County, Wisconsin,43.8,20459,395,181,4,177,65,36,29,88,54,34,61,41,20,1817,58152,27539,"Kewaunee County, Wisconsin",61,55,8.881176988
3078,55063,La Crosse County, Wisconsin,35.4,117538,3498,466,104,362,844,364,480,779,597,182,1409,1151,258,16675,51477,28240,"La Crosse County, Wisconsin",63,55,14.18690126
3079,55065,Lafayette County, Wisconsin,41.5,16793,384,21,0,21,231,26,205,62,34,28,70,45,25,1863,53038,25877,"Lafayette County, Wisconsin",65,55,11.09390818
3080,55067,Langlade County, Wisconsin,47.7,19414,358,70,7,63,60,12,48,44,20,24,184,131,53,3026,43501,24772,"Langlade County, Wisconsin",67,55,15.58669002
3081,55069,Lincoln County, Wisconsin,46.6,28171,231,15,4,11,67,16,51,14,14,0,135,104,31,2616,52221,27322,"Lincoln County, Wisconsin",69,55,9.286145327
3082,55071,Manitowoc County, Wisconsin,44.4,80178,2023,333,36,297,536,177,359,462,209,253,692,533,159,8143,49613,26751,"Manitowoc County, Wisconsin",71,55,10.15615256
3083,55073,Marathon County, Wisconsin,40.7,135367,5451,422,77,345,1591,813,778,1398,831,567,2040,1571,469,14825,54227,28773,"Marathon County, Wisconsin",73,55,10.95170906
3084,55075,Marinette County, Wisconsin,47.5,41090,594,75,0,75,96,52,44,129,104,25,294,237,57,5254,43893,25231,"Marinette County, Wisconsin",75,55,12.78656607
3085,55077,Marquette County, Wisconsin,49.1,15082,324,8,0,8,116,41,75,49,18,31,151,87,64,1730,48445,25268,"Marquette County, Wisconsin",77,55,11.47062724
3086,55078,Menominee County, Wisconsin,30.8,4457,125,0,0,0,83,0,83,0,0,0,42,42,0,1449,37147,15171,"Menominee County, Wisconsin",78,55,32.51065739
3087,55079,Milwaukee County, Wisconsin,34.3,955306,84344,12362,827,11535,27358,6698,20660,21033,9143,11890,23591,16849,6742,198227,45263,25881,"Milwaukee County, Wisconsin",79,55,20.7501052
3088,55081,Monroe County, Wisconsin,39.2,45365,990,161,21,140,332,95,237,194,92,102,303,215,88,6192,53394,24971,"Monroe County, Wisconsin",81,55,13.6492891
3089,55083,Oconto County, Wisconsin,45.8,37475,543,55,5,50,200,58,142,99,18,81,189,138,51,3334,54018,27623,"Oconto County, Wisconsin",83,55,8.896597732
3090,55085,Oneida County, Wisconsin,50.3,35604,547,27,0,27,85,60,25,99,57,42,336,281,55,3294,49715,28084,"Oneida County, Wisconsin",85,55,9.251769464
3091,55087,Outagamie County, Wisconsin,37.9,181799,7214,1376,153,1223,1938,696,1242,1682,781,901,2218,1779,439,16096,59806,29663,"Outagamie County, Wisconsin",87,55,8.853734069
3092,55089,Ozaukee County, Wisconsin,43.9,87625,4031,568,45,523,1071,481,590,901,699,202,1491,1205,286,4786,78415,44369,"Ozaukee County, Wisconsin",89,55,5.461911555
3093,55091,Pepin County, Wisconsin,45.5,7349,113,35,0,35,14,0,14,16,9,7,48,33,15,965,51346,26280,"Pepin County, Wisconsin",91,55,13.13103824
3094,55093,Pierce County, Wisconsin,36,40881,611,219,0,219,120,47,73,107,56,51,165,100,65,4572,64364,30009,"Pierce County, Wisconsin",93,55,11.18367946
3095,55095,Polk County, Wisconsin,44.5,43483,528,94,10,84,182,47,135,119,62,57,133,109,24,4250,52039,27066,"Polk County, Wisconsin",95,55,9.773934641
3096,55097,Portage County, Wisconsin,36.3,70551,2201,493,62,431,454,134,320,568,254,314,686,548,138,9454,52411,26832,"Portage County, Wisconsin",97,55,13.40023529
3097,55099,Price County, Wisconsin,51.3,13707,230,32,0,32,91,11,80,18,12,6,89,66,23,1724,43547,27987,"Price County, Wisconsin",99,55,12.57751514
3098,55101,Racine County, Wisconsin,39.9,194873,9870,860,90,770,3296,1238,2058,2549,952,1597,3165,2246,919,23751,56359,28436,"Racine County, Wisconsin",101,55,12.18793779
3099,55103,Richland County, Wisconsin,44.5,17642,402,85,1,84,139,52,87,25,9,16,153,129,24,2373,46564,24961,"Richland County, Wisconsin",103,55,13.45085591
3100,55105,Rock County, Wisconsin,39.1,160986,7378,756,31,725,2380,445,1935,2052,660,1392,2190,1521,669,23215,50968,25884,"Rock County, Wisconsin",105,55,14.42050862
3101,55107,Rusk County, Wisconsin,47.9,14272,270,92,8,84,77,9,68,14,9,5,87,57,30,2225,39904,22651,"Rusk County, Wisconsin",107,55,15.58996637
3102,55109,St. Croix County, Wisconsin,37.9,86726,2128,286,74,212,859,519,340,236,202,34,747,666,81,4851,73743,34679,"St. Croix County, Wisconsin",109,55,5.593478311
3103,55111,Sauk County, Wisconsin,41.4,63317,1769,259,3,256,548,191,357,267,89,178,695,579,116,6933,53225,26736,"Sauk County, Wisconsin",111,55,10.94966597
3104,55113,Sawyer County, Wisconsin,49.5,16438,247,17,7,10,55,33,22,73,23,50,102,75,27,2623,41869,25680,"Sawyer County, Wisconsin",113,55,15.95692907
3105,55115,Shawano County, Wisconsin,44.7,41384,546,39,0,39,235,65,170,103,15,88,169,128,41,4594,48773,25286,"Shawano County, Wisconsin",115,55,11.10090856
3106,55117,Sheboygan County, Wisconsin,41.4,115269,6633,684,45,639,2110,1059,1051,1687,895,792,2152,1465,687,9942,54392,27796,"Sheboygan County, Wisconsin",117,55,8.625042292
3107,55119,Taylor County, Wisconsin,43.4,20521,300,37,3,34,172,16,156,27,9,18,64,56,8,2511,47306,24907,"Taylor County, Wisconsin",119,55,12.2362458
3108,55121,Trempealeau County, Wisconsin,40.8,29521,1179,263,26,237,426,48,378,259,76,183,231,157,74,2804,52438,26002,"Trempealeau County, Wisconsin",121,55,9.498323228
3109,55123,Vernon County, Wisconsin,42.4,30442,282,28,19,9,55,18,37,100,67,33,99,87,12,4882,49476,24414,"Vernon County, Wisconsin",123,55,16.03705407
3110,55125,Vilas County, Wisconsin,52.9,21373,384,90,5,85,20,14,6,60,19,41,214,178,36,3098,41632,27537,"Vilas County, Wisconsin",125,55,14.4949235
3111,55127,Walworth County, Wisconsin,39,103021,6282,458,75,383,2004,473,1531,1945,695,1250,1875,1128,747,12885,55575,28085,"Walworth County, Wisconsin",127,55,12.50715873
3112,55129,Washburn County, Wisconsin,50,15685,201,30,0,30,60,30,30,29,21,8,82,66,16,1976,44437,26570,"Washburn County, Wisconsin",129,55,12.59802359
3113,55131,Washington County, Wisconsin,42.4,133422,3626,454,110,344,932,481,451,723,390,333,1517,1233,284,7486,70325,34722,"Washington County, Wisconsin",131,55,5.610768839
3114,55133,Waukesha County, Wisconsin,43,395377,19383,2598,191,2407,5620,1912,3708,3972,2500,1472,7193,5976,1217,20167,78268,40174,"Waukesha County, Wisconsin",133,55,5.100701356
3115,55135,Waupaca County, Wisconsin,44.8,51974,944,73,0,73,422,62,360,133,48,85,316,225,91,5327,52441,28145,"Waupaca County, Wisconsin",135,55,10.24935545
3116,55137,Waushara County, Wisconsin,48.5,24238,675,71,24,47,163,39,124,181,38,143,260,144,116,2646,46581,24861,"Waushara County, Wisconsin",137,55,10.91674231
3117,55139,Winnebago County, Wisconsin,37.9,169487,5625,894,115,779,1600,638,962,1061,683,378,2070,1554,516,19573,53501,28446,"Winnebago County, Wisconsin",139,55,11.54837834
3118,55141,Wood County, Wisconsin,43.7,73621,1713,184,0,184,612,149,463,452,316,136,465,430,35,7715,49926,27687,"Wood County, Wisconsin",141,55,10.47934693
3119,56001,Albany County, Wyoming,26.6,37836,2301,729,4,725,872,151,721,284,190,94,416,380,36,9070,43043,25227,"Albany County, Wyoming",1,56,23.97187863
3120,56003,Big Horn County, Wyoming,41.8,11931,393,19,5,14,95,7,88,145,43,102,134,110,24,1385,50820,23041,"Big Horn County, Wyoming",3,56,11.60841505
3121,56005,Campbell County, Wyoming,32.8,48473,1767,254,89,165,789,223,566,411,120,291,313,190,123,3898,80822,33317,"Campbell County, Wyoming",5,56,8.041590164
3122,56007,Carbon County, Wyoming,38.1,15696,816,28,0,28,195,3,192,290,38,252,303,112,191,2133,56972,27399,"Carbon County, Wyoming",7,56,13.58944954
3123,56009,Converse County, Wyoming,40.4,14223,385,49,0,49,11,0,11,2,0,2,323,277,46,1178,66737,31470,"Converse County, Wyoming",9,56,8.282359558
3124,56011,Crook County, Wyoming,43.1,7284,68,27,8,19,0,0,0,36,0,36,5,3,2,441,60307,32817,"Crook County, Wyoming",11,56,6.054365733
3125,56013,Fremont County, Wyoming,38.4,40683,545,53,5,48,150,26,124,141,57,84,201,180,21,5585,53559,26606,"Fremont County, Wyoming",13,56,13.72809282
3126,56015,Goshen County, Wyoming,42.8,13546,369,43,0,43,84,0,84,68,50,18,174,93,81,2031,44883,25883,"Goshen County, Wyoming",15,56,14.99335597
3127,56017,Hot Springs County, Wyoming,51.4,4781,28,2,0,2,3,3,0,3,3,0,20,20,0,524,46087,29499,"Hot Springs County, Wyoming",17,56,10.9600502
3128,56019,Johnson County, Wyoming,44.9,8572,142,13,12,1,84,0,84,4,4,0,41,41,0,499,54594,31888,"Johnson County, Wyoming",19,56,5.821278581
3129,56021,Laramie County, Wyoming,36.7,96459,2946,267,9,258,926,188,738,539,227,312,1214,1035,179,9812,61201,30249,"Laramie County, Wyoming",21,56,10.17219751
3130,56023,Lincoln County, Wyoming,38.5,18543,399,18,6,12,161,52,109,115,28,87,105,87,18,1616,64579,29748,"Lincoln County, Wyoming",23,56,8.71487893
3131,56025,Natrona County, Wyoming,35.9,80871,2207,345,0,345,780,424,356,552,221,331,530,401,129,8333,56983,30902,"Natrona County, Wyoming",25,56,10.3040645
3132,56027,Niobrara County, Wyoming,39.2,2498,7,0,0,0,0,0,0,0,0,0,7,7,0,296,40640,23356,"Niobrara County, Wyoming",27,56,11.84947958
3133,56029,Park County, Wyoming,43.7,29083,781,146,0,146,189,94,95,155,47,108,291,274,17,2288,61185,30179,"Park County, Wyoming",29,56,7.867138878
3134,56031,Platte County, Wyoming,47.2,8740,243,20,0,20,109,20,89,27,13,14,87,87,0,1340,41051,30054,"Platte County, Wyoming",31,56,15.33180778
3135,56033,Sheridan County, Wyoming,42.4,29924,602,9,0,9,284,193,91,107,29,78,202,185,17,2378,53914,29630,"Sheridan County, Wyoming",33,56,7.946798556
3136,56035,Sublette County, Wyoming,37.5,10032,206,1,0,1,122,4,118,19,19,0,64,16,48,775,76004,30295,"Sublette County, Wyoming",35,56,7.725279107
3137,56037,Sweetwater County, Wyoming,33.8,44812,2469,298,2,296,1069,139,930,542,66,476,560,284,276,4868,68233,30945,"Sweetwater County, Wyoming",37,56,10.86316165
3138,56039,Teton County, Wyoming,38.4,22623,2596,386,0,386,1427,366,1061,618,136,482,165,123,42,1650,75594,46499,"Teton County, Wyoming",39,56,7.293462406
3139,56041,Uinta County, Wyoming,34.8,20893,833,44,0,44,510,278,232,199,99,100,80,80,0,3462,53323,25636,"Uinta County, Wyoming",41,56,16.57014311
3140,56043,Washakie County, Wyoming,43.5,8351,316,0,0,0,175,98,77,82,24,58,59,27,32,1198,46212,26325,"Washakie County, Wyoming",43,56,14.34558735
3141,56045,Weston County, Wyoming,43.8,7175,293,87,0,87,124,114,10,0,0,0,82,80,2,1002,55640,29493,"Weston County, Wyoming",45,56,13.96515679
3142,72001,Adjuntas Municipio, Puerto Rico,38.9,18760,26,0,0,0,2,1,1,16,0,16,8,0,8,11791,11296,7124,"Adjuntas Municipio, Puerto Rico",1,72,62.85181237
3143,72003,Aguada Municipio, Puerto Rico,40,40083,572,46,34,12,205,0,205,166,63,103,155,27,128,21828,15543,8592,"Aguada Municipio, Puerto Rico",3,72,54.45700172
3144,72005,Aguadilla Municipio, Puerto Rico,40.2,56893,788,154,57,97,156,65,91,139,46,93,339,214,125,27469,17191,10335,"Aguadilla Municipio, Puerto Rico",5,72,48.28186244
3145,72007,Aguas Buenas Municipio, Puerto Rico,39.2,27323,327,31,3,28,37,16,21,82,67,15,177,121,56,13814,15409,9647,"Aguas Buenas Municipio, Puerto Rico",7,72,50.55813783
3146,72009,Aibonito Municipio, Puerto Rico,40.3,24438,258,39,20,19,99,0,99,41,19,22,79,54,25,11433,18145,9262,"Aibonito Municipio, Puerto Rico",9,72,46.78369752
3147,72011,A?asco Municipio, Puerto Rico,40.7,28250,125,44,9,35,2,0,2,25,20,5,54,43,11,13760,17712,8673,"A?asco Municipio, Puerto Rico",11,72,48.7079646
3148,72013,Arecibo Municipio, Puerto Rico,41,91096,670,68,0,68,245,55,190,77,23,54,280,157,123,43974,16796,9438,"Arecibo Municipio, Puerto Rico",13,72,48.27215245
3149,72015,Arroyo Municipio, Puerto Rico,37.8,18778,54,15,15,0,13,1,12,0,0,0,26,17,9,9958,16387,7655,"Arroyo Municipio, Puerto Rico",15,72,53.03014166
3150,72017,Barceloneta Municipio, Puerto Rico,37.9,24699,234,21,0,21,68,41,27,42,42,0,103,73,30,13083,15549,8245,"Barceloneta Municipio, Puerto Rico",17,72,52.96975586
3151,72019,Barranquitas Municipio, Puerto Rico,34.8,29548,121,26,0,26,35,0,35,60,27,33,0,0,0,17728,14778,7369,"Barranquitas Municipio, Puerto Rico",19,72,59.99729254
3152,72021,Bayamon Municipio, Puerto Rico,39.8,192974,6980,284,21,263,1642,249,1393,1602,536,1066,3452,2275,1177,66051,24612,13472,"Bayamon Municipio, Puerto Rico",21,72,34.22792708
3153,72023,Cabo Rojo Municipio, Puerto Rico,41.7,50096,258,16,0,16,83,26,57,73,18,55,86,77,9,25055,17088,9833,"Cabo Rojo Municipio, Puerto Rico",23,72,50.01397317
3154,72025,Caguas Municipio, Puerto Rico,38.8,136372,2369,248,51,197,733,342,391,463,108,355,925,629,296,50464,24278,13911,"Caguas Municipio, Puerto Rico",25,72,37.00466371
3155,72027,Camuy Municipio, Puerto Rico,39.1,33481,133,21,0,21,0,0,0,61,0,61,51,19,32,16173,17206,9271,"Camuy Municipio, Puerto Rico",27,72,48.30500881
3156,72029,Canovanas Municipio, Puerto Rico,38.2,47174,1526,164,0,164,525,80,445,404,141,263,433,188,245,20421,20426,10664,"Canovanas Municipio, Puerto Rico",29,72,43.28867597
3157,72031,Carolina Municipio, Puerto Rico,40.5,165040,10228,1262,216,1046,1758,401,1357,2526,1068,1458,4682,3653,1029,49105,28611,15403,"Carolina Municipio, Puerto Rico",31,72,29.75339312
3158,72033,Cata?o Municipio, Puerto Rico,37.8,26137,903,93,9,84,244,71,173,193,152,41,373,227,146,12829,18562,11039,"Cata?o Municipio, Puerto Rico",33,72,49.08367448
3159,72035,Cayey Municipio, Puerto Rico,40.4,46071,418,55,0,55,99,0,99,98,14,84,166,112,54,19824,20577,12441,"Cayey Municipio, Puerto Rico",35,72,43.02923748
3160,72037,Ceiba Municipio, Puerto Rico,40.1,12538,296,50,0,50,37,8,29,58,34,24,151,123,28,5611,20038,10584,"Ceiba Municipio, Puerto Rico",37,72,44.75195406
3161,72039,Ciales Municipio, Puerto Rico,39.8,17644,24,0,0,0,0,0,0,0,0,0,24,24,0,10694,12511,7080,"Ciales Municipio, Puerto Rico",39,72,60.60983904
3162,72041,Cidra Municipio, Puerto Rico,38.4,41782,477,69,0,69,57,26,31,164,81,83,187,170,17,17471,21846,11107,"Cidra Municipio, Puerto Rico",41,72,41.81465703
3163,72043,Coamo Municipio, Puerto Rico,38.7,40090,277,39,21,18,16,16,0,108,58,50,114,73,41,19726,18453,9699,"Coamo Municipio, Puerto Rico",43,72,49.20429035
3164,72045,Comerio Municipio, Puerto Rico,37.8,20153,161,0,0,0,58,0,58,77,43,34,26,9,17,12220,13164,6975,"Comerio Municipio, Puerto Rico",45,72,60.63613358
3165,72047,Corozal Municipio, Puerto Rico,37.4,35484,28,0,0,0,0,0,0,0,0,0,28,18,10,19774,14733,7793,"Corozal Municipio, Puerto Rico",47,72,55.72652463
3166,72049,Culebra Municipio, Puerto Rico,33.4,1508,30,12,0,12,0,0,0,12,9,3,6,6,0,679,20956,10069,"Culebra Municipio, Puerto Rico",49,72,45.0265252
3167,72051,Dorado Municipio, Puerto Rico,39,38013,810,34,8,26,283,94,189,110,33,77,383,228,155,13587,28133,14504,"Dorado Municipio, Puerto Rico",51,72,35.74303528
3168,72053,Fajardo Municipio, Puerto Rico,39.8,33912,596,151,0,151,161,54,107,78,50,28,206,178,28,14866,19482,10784,"Fajardo Municipio, Puerto Rico",53,72,43.83698986
3169,72054,Florida Municipio, Puerto Rico,37.5,12287,67,0,0,0,0,0,0,0,0,0,67,0,67,6707,16793,7451,"Florida Municipio, Puerto Rico",54,72,54.58614796
3170,72055,Guanica Municipio, Puerto Rico,41.3,17788,47,0,0,0,1,0,1,0,0,0,46,38,8,11199,13242,7223,"Guanica Municipio, Puerto Rico",55,72,62.95817405
3171,72057,Guayama Municipio, Puerto Rico,36.9,43210,179,0,0,0,107,35,72,11,7,4,61,32,29,22189,15078,9034,"Guayama Municipio, Puerto Rico",57,72,51.351539
3172,72059,Guayanilla Municipio, Puerto Rico,39.2,20025,74,0,0,0,15,15,0,10,0,10,49,0,49,11725,14848,7864,"Guayanilla Municipio, Puerto Rico",59,72,58.55181024
3173,72061,Guaynabo Municipio, Puerto Rico,42.2,92444,5585,1051,99,952,1181,444,737,959,533,426,2394,1837,557,25064,33979,23834,"Guaynabo Municipio, Puerto Rico",61,72,27.11263035
3174,72063,Gurabo Municipio, Puerto Rico,37.7,46990,543,129,0,129,90,49,41,0,0,0,324,103,221,15141,31070,16238,"Gurabo Municipio, Puerto Rico",63,72,32.22174931
3175,72065,Hatillo Municipio, Puerto Rico,39.8,41327,296,15,15,0,69,30,39,20,20,0,192,145,47,18400,18480,10116,"Hatillo Municipio, Puerto Rico",65,72,44.5229511
3176,72067,Hormigueros Municipio, Puerto Rico,44.6,16678,371,76,8,68,97,14,83,75,56,19,123,112,11,6013,20589,11432,"Hormigueros Municipio, Puerto Rico",67,72,36.05348363
3177,72069,Humacao Municipio, Puerto Rico,40.4,55621,434,42,0,42,190,76,114,0,0,0,202,134,68,24941,19349,10994,"Humacao Municipio, Puerto Rico",69,72,44.84097733
3178,72071,Isabela Municipio, Puerto Rico,40.4,43919,407,44,15,29,154,58,96,112,46,66,97,71,26,23902,15947,8578,"Isabela Municipio, Puerto Rico",71,72,54.42291491
3179,72073,Jayuya Municipio, Puerto Rico,35.8,15605,70,3,0,3,17,4,13,4,0,4,46,33,13,9196,15893,7258,"Jayuya Municipio, Puerto Rico",73,72,58.92983018
3180,72075,Juana Diaz Municipio, Puerto Rico,36.7,48658,233,38,0,38,14,0,14,65,19,46,116,64,52,23218,20231,10053,"Juana Diaz Municipio, Puerto Rico",75,72,47.71671668
3181,72077,Juncos Municipio, Puerto Rico,37.1,39942,142,0,0,0,24,0,24,28,0,28,90,40,50,19558,19084,9282,"Juncos Municipio, Puerto Rico",77,72,48.9660007
3182,72079,Lajas Municipio, Puerto Rico,43.1,24323,240,38,0,38,37,28,9,86,66,20,79,72,7,14552,12785,7097,"Lajas Municipio, Puerto Rico",79,72,59.8281462
3183,72081,Lares Municipio, Puerto Rico,40.4,28052,49,16,16,0,9,9,0,0,0,0,24,15,9,15984,12410,7958,"Lares Municipio, Puerto Rico",81,72,56.97989448
3184,72083,Las Marias Municipio, Puerto Rico,39.2,9093,20,0,0,0,8,8,0,5,0,5,7,7,0,5309,13132,6730,"Las Marias Municipio, Puerto Rico",83,72,58.38557132
3185,72085,Las Piedras Municipio, Puerto Rico,37.6,38466,213,69,0,69,27,27,0,57,48,9,60,21,39,18254,20119,9906,"Las Piedras Municipio, Puerto Rico",85,72,47.45489523
3186,72087,Loiza Municipio, Puerto Rico,36.5,27857,513,114,40,74,137,36,101,118,40,78,144,103,41,13785,18154,8694,"Loiza Municipio, Puerto Rico",87,72,49.48486915
3187,72089,Luquillo Municipio, Puerto Rico,39.6,19237,456,102,27,75,83,41,42,103,55,48,168,106,62,8450,19658,10617,"Luquillo Municipio, Puerto Rico",89,72,43.92576805
3188,72091,Manati Municipio, Puerto Rico,40,41468,169,0,0,0,52,27,25,66,46,20,51,43,8,19121,18534,10216,"Manati Municipio, Puerto Rico",91,72,46.11025369
3189,72093,Maricao Municipio, Puerto Rico,42,6274,31,1,0,1,20,0,20,9,0,9,1,0,1,4001,11909,5663,"Maricao Municipio, Puerto Rico",93,72,63.7711189
3190,72095,Maunabo Municipio, Puerto Rico,42.6,11506,67,0,0,0,20,20,0,31,0,31,16,16,0,6431,18815,8552,"Maunabo Municipio, Puerto Rico",95,72,55.89257779
3191,72097,Mayaguez Municipio, Puerto Rico,39,81594,1311,254,54,200,265,137,128,193,128,65,599,498,101,41350,15017,10133,"Mayaguez Municipio, Puerto Rico",97,72,50.67774591
3192,72099,Moca Municipio, Puerto Rico,37.5,38289,298,52,0,52,68,48,20,25,0,25,153,64,89,21529,14157,7621,"Moca Municipio, Puerto Rico",99,72,56.22763718
3193,72101,Morovis Municipio, Puerto Rico,36,32087,203,0,0,0,37,37,0,83,83,0,83,59,24,16601,17649,8294,"Morovis Municipio, Puerto Rico",101,72,51.73746377
3194,72103,Naguabo Municipio, Puerto Rico,36.6,26722,285,126,0,126,78,66,12,0,0,0,81,25,56,13311,18973,9809,"Naguabo Municipio, Puerto Rico",103,72,49.81288826
3195,72105,Naranjito Municipio, Puerto Rico,37.7,29467,172,28,0,28,30,14,16,54,0,54,60,38,22,14032,18828,9886,"Naranjito Municipio, Puerto Rico",105,72,47.61937082
3196,72107,Orocovis Municipio, Puerto Rico,37.2,22258,154,38,0,38,89,2,87,15,9,6,12,0,12,12776,14662,7187,"Orocovis Municipio, Puerto Rico",107,72,57.39958667
3197,72109,Patillas Municipio, Puerto Rico,42.7,18135,138,47,0,47,76,76,0,15,0,15,0,0,0,10279,13975,8127,"Patillas Municipio, Puerto Rico",109,72,56.68045216
3198,72111,Pe?uelas Municipio, Puerto Rico,35.7,22231,114,18,0,18,34,9,25,12,12,0,50,32,18,12748,16764,7581,"Pe?uelas Municipio, Puerto Rico",111,72,57.34334938
3199,72113,Ponce Municipio, Puerto Rico,38.9,152594,1869,307,32,275,398,93,305,338,119,219,826,593,233,76635,16561,10587,"Ponce Municipio, Puerto Rico",113,72,50.22150281
3200,72115,Quebradillas Municipio, Puerto Rico,39.3,24904,189,0,0,0,145,0,145,20,20,0,24,24,0,13897,15641,8499,"Quebradillas Municipio, Puerto Rico",115,72,55.80228076
3201,72117,Rincon Municipio, Puerto Rico,43.7,14700,176,8,0,8,31,10,21,51,35,16,86,73,13,7068,17784,9445,"Rincon Municipio, Puerto Rico",117,72,48.08163265
3202,72119,Rio Grande Municipio, Puerto Rico,39.6,52479,736,61,25,36,189,25,164,168,81,87,318,173,145,19400,22990,10648,"Rio Grande Municipio, Puerto Rico",119,72,36.96716782
3203,72121,Sabana Grande Municipio, Puerto Rico,40.6,24013,144,0,0,0,0,0,0,58,51,7,86,46,40,11762,14877,8638,"Sabana Grande Municipio, Puerto Rico",121,72,48.98180152
3204,72123,Salinas Municipio, Puerto Rico,37.3,29722,227,47,22,25,8,0,8,18,18,0,154,131,23,15702,16540,8535,"Salinas Municipio, Puerto Rico",123,72,52.82955387
3205,72125,San German Municipio, Puerto Rico,42.2,33546,329,54,0,54,83,47,36,47,32,15,145,128,17,16865,14988,9445,"San German Municipio, Puerto Rico",125,72,50.27425028
3206,72127,San Juan Municipio, Puerto Rico,41,363744,42670,5584,700,4884,11443,2120,9323,10541,3937,6604,15102,10489,4613,151520,21395,17348,"San Juan Municipio, Puerto Rico",127,72,41.65566992
3207,72129,San Lorenzo Municipio, Puerto Rico,39.5,39283,338,24,0,24,67,31,36,76,30,46,171,113,58,18300,16916,10671,"San Lorenzo Municipio, Puerto Rico",129,72,46.58503678
3208,72131,San Sebastian Municipio, Puerto Rico,41.3,39755,363,8,0,8,102,0,102,92,0,92,161,104,57,22387,13866,7578,"San Sebastian Municipio, Puerto Rico",131,72,56.31241353
3209,72133,Santa Isabel Municipio, Puerto Rico,36,22732,125,0,0,0,19,0,19,38,38,0,68,42,26,11449,15295,9545,"Santa Isabel Municipio, Puerto Rico",133,72,50.36512405
3210,72135,Toa Alta Municipio, Puerto Rico,36.5,74467,1064,118,55,63,163,83,80,324,148,176,459,307,152,22739,29578,13816,"Toa Alta Municipio, Puerto Rico",135,72,30.53567352
3211,72137,Toa Baja Municipio, Puerto Rico,38.3,83645,2022,148,34,114,440,125,315,555,222,333,879,536,343,30811,23889,12008,"Toa Baja Municipio, Puerto Rico",137,72,36.83543547
3212,72139,Trujillo Alto Municipio, Puerto Rico,38.6,70737,2256,250,37,213,458,112,346,550,382,168,998,726,272,21023,30427,15760,"Trujillo Alto Municipio, Puerto Rico",139,72,29.71994854
3213,72141,Utuado Municipio, Puerto Rico,40.7,30869,80,8,0,8,50,8,42,9,0,9,13,13,0,16103,15875,7841,"Utuado Municipio, Puerto Rico",141,72,52.16560303
3214,72143,Vega Alta Municipio, Puerto Rico,37.2,39018,528,138,0,138,39,39,0,112,52,60,239,182,57,18572,18312,10448,"Vega Alta Municipio, Puerto Rico",143,72,47.59854426
3215,72145,Vega Baja Municipio, Puerto Rico,39.2,55866,351,15,0,15,123,76,47,47,22,25,166,122,44,25518,17634,9632,"Vega Baja Municipio, Puerto Rico",145,72,45.67715605
3216,72147,Vieques Municipio, Puerto Rico,43.3,9046,20,7,0,7,0,0,0,13,13,0,0,0,0,3220,17535,9808,"Vieques Municipio, Puerto Rico",147,72,35.59584347
3217,72149,Villalba Municipio, Puerto Rico,36.9,24186,71,14,0,14,18,0,18,0,0,0,39,15,24,12185,18974,8733,"Villalba Municipio, Puerto Rico",149,72,50.38038535
3218,72151,Yabucoa Municipio, Puerto Rico,40.7,35670,88,0,0,0,26,26,0,45,17,28,17,0,17,17603,16308,8531,"Yabucoa Municipio, Puerto Rico",151,72,49.3495935
3219,72153,Yauco Municipio, Puerto Rico,41.5,38519,108,5,0,5,45,16,29,10,10,0,48,34,14,19162,14666,7998,"Yauco Municipio, Puerto Rico",153,72,49.74687816